Team,Player,Nation,Pos,Age,90s,Tkl,TklW,Def 3rd,Mid 3rd,Att 3rd,Tkl.1,Att,Tkl%,Lost,Blocks,Sh,Pass,Int,Tkl+Int,Clr,Err
Paris Saint Germain,Bradley Barcola,fr FRA,FW,21.0,24.4,27,17,10,8,9,8,31,25.8,23,25,2,23,19,46,12,0
Paris Saint Germain,Gianluigi Donnarumma,it ITA,GK,25.0,23.2,1,1,1,0,0,1,2,50.0,1,0,0,0,0,1,14,0
Paris Saint Germain,Achraf Hakimi,ma MAR,DF,25.0,23.0,48,36,18,20,10,27,55,49.1,28,25,2,23,31,79,18,3
Paris Saint Germain,Willian Pacho,ec ECU,DF,22.0,23.7,56,32,34,22,0,23,32,71.9,9,35,22,13,40,96,91,1
Paris Saint Germain,Warren Zaïre-Emery,fr FRA,MF,18.0,22.9,51,26,17,21,13,23,45,51.1,22,35,6,29,23,74,20,2
Paris Saint Germain,Lucas Beraldo,br BRA,DF,20.0,22.4,38,31,30,8,0,23,37,62.2,14,16,8,8,21,59,63,3
Paris Saint Germain,João Neves,pt POR,MF,19.0,20.6,63,31,20,26,17,27,45,60.0,18,29,9,20,23,86,22,1
Paris Saint Germain,Fabián Ruiz Peña,es ESP,MF,28.0,21.5,37,24,13,15,9,21,47,44.7,26,25,3,22,16,53,27,1
Paris Saint Germain,Vitinha,pt POR,MF,24.0,22.7,43,23,13,27,3,25,48,52.1,23,26,7,19,14,57,19,2
Paris Saint Germain,Ousmane Dembélé,fr FRA,FW,27.0,19.4,11,5,0,7,4,4,12,33.3,8,3,0,3,9,20,2,1
Paris Saint Germain,Marquinhos,br BRA,DF,30.0,19.2,30,19,8,16,6,25,33,75.8,8,27,15,12,11,41,64,0
Paris Saint Germain,Nuno Mendes,pt POR,DF,22.0,18.7,30,19,15,12,3,23,39,59.0,16,25,8,17,18,48,37,2
Paris Saint Germain,Lee Kang-in,kr KOR,FW,23.0,18.6,25,17,7,11,7,19,35,54.3,16,11,1,10,3,28,3,1
Paris Saint Germain,Désiré Doué,fr FRA,FW,19.0,19.4,48,30,15,19,14,24,51,47.1,27,26,0,26,13,61,7,0
Paris Saint Germain,Gonçalo Ramos,pt POR,FW,23.0,11.9,11,6,5,5,1,3,6,50.0,3,5,1,4,0,11,5,0
Paris Saint Germain,Khvicha Kvaratskhelia,ge GEO,FW,23.0,10.3,19,13,4,12,3,13,23,56.5,10,7,0,7,2,21,4,0
Paris Saint Germain,Lucas Hernández,fr FRA,DF,28.0,9.8,24,18,13,9,2,14,23,60.9,9,12,5,7,7,31,37,2
Paris Saint Germain,Matvei Safonov,ru RUS,GK,25.0,9.8,0,0,0,0,0,0,0,,0,1,0,1,1,1,3,0
Paris Saint Germain,Senny Mayulu,fr FRA,MF,18.0,9.0,25,16,8,14,3,8,14,57.1,6,8,3,5,5,30,12,0
Paris Saint Germain,Marco Asensio,es ESP,FW,28.0,6.9,4,3,1,3,0,0,6,0.0,6,1,0,1,0,4,1,0
Paris Saint Germain,Milan Škriniar,sk SVK,DF,29.0,4.2,7,5,3,4,0,3,3,100.0,0,7,6,1,3,10,16,0
Paris Saint Germain,Ibrahim Mbaye,fr FRA,FW,16.0,3.8,4,2,1,2,1,3,8,37.5,5,2,0,2,2,6,2,0
Paris Saint Germain,Randal Kolo Muani,fr FRA,FW,25.0,4.0,4,4,1,1,2,0,2,0.0,2,1,0,1,0,4,5,0
Paris Saint Germain,Yoram Zague,fr FRA,DF,18.0,2.0,8,6,3,1,4,6,8,75.0,2,3,0,3,2,10,2,0
Paris Saint Germain,Axel Tapé,fr FRA,DF,16.0,2.0,3,1,1,2,0,2,2,100.0,0,2,2,0,1,4,5,0
Paris Saint Germain,Arnau Tenas,es ESP,GK,23.0,1.0,0,0,0,0,0,0,0,,0,0,0,0,0,0,0,0
Paris Saint Germain,Noham Kamara,fr FRA,DF,17.0,0.8,1,1,0,1,0,0,0,,0,1,1,0,1,2,1,0
Paris Saint Germain,Presnel Kimpembe,fr FRA,DF,28.0,0.3,1,0,1,0,0,0,0,,0,2,2,0,0,1,1,0
Marseille,Gerónimo Rulli,ar ARG,GK,32.0,34.0,4,3,4,0,0,4,8,50.0,4,1,0,1,1,5,25,3
Marseille,Mason Greenwood,eng ENG,FW,22.0,31.3,35,18,10,14,11,16,39,41.0,23,7,0,7,12,47,5,2
Marseille,Pierre Højbjerg,dk DEN,MF,28.0,29.6,64,45,25,32,7,37,69,53.6,32,28,4,24,42,106,33,2
Marseille,Luis Henrique,br BRA,DF,22.0,29.2,16,9,7,6,3,9,10,90.0,1,15,2,13,10,26,30,0
Marseille,Adrien Rabiot,fr FRA,MF,29.0,27.6,49,31,17,21,11,19,32,59.4,13,21,2,19,21,70,32,0
Marseille,Michael Amir Murillo,pa PAN,DF,28.0,27.1,49,31,30,13,6,32,46,69.6,14,21,8,13,18,67,70,4
Marseille,Leonardo Balerdi,ar ARG,DF,25.0,25.3,54,39,32,17,5,27,47,57.4,20,25,14,11,38,92,72,4
Marseille,Geoffrey Kondogbia,cf CTA,DF,31.0,22.5,60,38,31,26,3,27,34,79.4,7,23,6,17,22,82,64,4
Marseille,Quentin Merlin,fr FRA,DF,22.0,17.8,22,17,12,5,5,9,16,56.3,7,20,4,16,14,36,17,1
Marseille,Valentin Rongier,fr FRA,MF,29.0,17.5,50,28,14,31,5,27,43,62.8,16,30,9,21,33,83,28,5
Marseille,Derek Cornelius,ca CAN,DF,26.0,15.8,24,17,15,8,1,17,22,77.3,5,16,10,6,14,38,51,0
Marseille,Neal Maupay,fr FRA,FW,27.0,11.7,9,4,1,6,2,3,6,50.0,3,5,0,5,2,11,0,0
Marseille,Amine Gouiri,dz ALG,FW,24.0,11.7,5,5,0,1,4,2,3,66.7,1,9,0,9,1,6,1,0
Marseille,Ulisses Garcia,ch SUI,DF,28.0,10.4,14,11,7,5,2,4,14,28.6,10,5,1,4,8,22,18,0
Marseille,Lilian Brassier,fr FRA,DF,24.0,8.7,8,6,8,0,0,5,6,83.3,1,8,3,5,9,17,28,2
Marseille,Ismaël Bennacer,dz ALG,MF,26.0,7.3,21,10,8,12,1,12,18,66.7,6,6,0,6,10,31,2,1
Marseille,Amine Harit,ma MAR,MF,27.0,5.8,8,7,0,6,2,1,2,50.0,1,6,0,6,3,11,1,1
Marseille,Elye Wahi,fr FRA,FW,21.0,6.4,0,0,0,0,0,0,4,0.0,4,1,0,1,1,1,0,0
Marseille,Jon Rowe,eng ENG,FW,21.0,9.0,15,11,5,4,6,6,14,42.9,8,4,1,3,2,17,4,0
Marseille,Pol Lirola,es ESP,DF,26.0,7.6,13,9,5,8,0,5,13,38.5,8,7,2,5,4,17,12,0
Marseille,Bilal Nadir,ma MAR,MF,20.0,4.3,10,3,4,6,0,4,6,66.7,2,6,1,5,4,14,7,0
Marseille,Ismaël Koné,ca CAN,MF,22.0,4.0,8,4,3,3,2,3,4,75.0,1,4,1,3,4,12,2,1
Marseille,Amar Dedić,ba BIH,DF,21.0,3.5,5,4,2,2,1,3,10,30.0,7,0,0,0,3,8,12,1
Marseille,Luiz Felipe,it ITA,DF,27.0,1.4,4,3,3,1,0,1,2,50.0,1,3,2,1,3,7,5,0
Marseille,Valentin Carboni,ar ARG,MF,19.0,1.1,2,2,0,1,1,0,1,0.0,1,1,0,1,1,3,1,0
Marseille,Robinio Vaz,fr FRA,FW,17.0,0.8,1,1,0,0,1,0,2,0.0,2,0,0,0,0,1,2,0
Marseille,Bamo Meïté,ci CIV,DF,22.0,0.3,0,0,0,0,0,0,0,,0,0,0,0,0,0,1,0
Marseille,Enzo Sternal,fr FRA,FW,17.0,0.3,0,0,0,0,0,0,0,,0,0,0,0,0,0,0,0
Marseille,Darryl Bakola,fr FRA,DF,16.0,0.2,1,1,0,1,0,0,0,,0,0,0,0,0,1,0,0
Marseille,Emmanuel Koum Mbondo,fr FRA,DF,18.0,0.1,0,0,0,0,0,0,0,,0,0,0,0,0,0,0,0
Marseille,Faris Pemi Moumbagna,cm CMR,FW,24.0,0.1,0,0,0,0,0,0,0,,0,0,0,0,0,0,0,0
Marseille,Keyliane Abdallah,fr FRA,FW,18.0,0.0,1,1,1,0,0,1,1,100.0,0,0,0,0,0,1,0,0
Monaco,Maghnes Akliouche,fr FRA,FW,22.0,26.8,51,31,12,24,15,19,41,46.3,22,21,0,21,15,66,13,0
Monaco,Thilo Kehrer,de GER,DF,27.0,26.5,37,23,26,11,0,22,38,57.9,16,18,10,8,36,73,113,1
Monaco,Takumi Minamino,jp JPN,MF,29.0,25.0,33,19,7,14,12,15,42,35.7,27,26,1,25,10,43,20,0
Monaco,Lamine Camara,sn SEN,MF,20.0,23.0,66,41,22,34,10,26,48,54.2,22,30,4,26,31,97,32,1
Monaco,Denis Zakaria,ch SUI,MF,27.0,23.9,41,26,15,19,7,24,33,72.7,9,31,8,23,34,75,39,1
Monaco,Wilfried Singo,ci CIV,DF,23.0,23.3,37,23,24,10,3,20,28,71.4,8,17,9,8,43,80,110,2
Monaco,Vanderson,br BRA,DF,23.0,23.1,76,48,37,30,9,45,64,70.3,19,43,6,37,39,115,65,2
Monaco,Caio Henrique Oliveira Silva,br BRA,DF,27.0,21.5,37,26,16,19,2,23,44,52.3,21,26,8,18,22,59,59,0
Monaco,Breel Embolo,ch SUI,FW,27.0,20.6,22,17,7,7,8,5,16,31.3,11,11,0,11,3,25,10,1
Monaco,Eliesse Ben Seghir,ma MAR,MF,19.0,19.6,31,22,12,12,7,18,32,56.3,14,20,0,20,13,44,4,0
Monaco,Philipp Köhn,ch SUI,GK,26.0,19.0,0,0,0,0,0,0,1,0.0,1,0,0,0,0,0,11,2
Monaco,Christian Mawissa,fr FRA,DF,19.0,16.7,42,29,27,13,2,26,44,59.1,18,25,6,19,26,68,48,1
Monaco,Mika Biereth,dk DEN,FW,21.0,13.8,5,5,0,3,2,3,7,42.9,4,11,0,11,4,9,7,0
Monaco,Radosław Majecki,pl POL,GK,24.0,15.0,0,0,0,0,0,0,2,0.0,2,0,0,0,0,0,8,1
Monaco,Aleksandr Golovin,ru RUS,MF,28.0,12.9,38,24,9,20,9,17,39,43.6,22,16,4,12,12,50,7,0
Monaco,Soungoutou Magassa,fr FRA,MF,20.0,11.4,47,25,14,27,6,25,46,54.3,21,16,3,13,21,68,19,1
Monaco,Mohammed Salisu,gh GHA,DF,25.0,11.4,28,18,16,11,1,13,16,81.3,3,10,8,2,16,44,54,2
Monaco,Jordan Teze,nl NED,DF,24.0,6.4,18,9,8,9,1,7,16,43.8,9,12,1,11,6,24,15,0
Monaco,Folarin Balogun,us USA,FW,23.0,6.9,1,1,0,0,1,0,4,0.0,4,0,0,0,1,2,0,0
Monaco,George Ilenikhena,ng NGA,FW,17.0,8.0,4,2,0,3,1,1,2,50.0,1,0,0,0,2,6,0,0
Monaco,Kassoum Ouattara,fr FRA,DF,19.0,4.4,9,7,5,4,0,4,14,28.6,10,6,0,6,5,14,2,1
Monaco,Krépin Diatta,sn SEN,DF,25.0,5.7,18,12,13,2,3,14,24,58.3,10,5,1,4,9,27,12,2
Monaco,Almoatasem Al Musrati,ly LBY,MF,28.0,4.3,14,11,5,8,1,7,11,63.6,4,3,1,2,5,19,9,0
Monaco,Ismail Jakobs,sn SEN,DF,24.0,2.0,5,5,3,0,2,3,5,60.0,2,0,0,0,2,7,6,0
Monaco,Saïmon Bouabré,fr FRA,MF,18.0,1.1,1,0,0,1,0,0,3,0.0,3,1,0,1,0,1,0,0
Monaco,Eliot Matazo,be BEL,MF,22.0,0.8,3,2,0,3,0,0,0,,0,0,0,0,1,4,2,0
Monaco,Lucas Michal,fr FRA,FW,19.0,1.3,5,3,3,2,0,2,4,50.0,2,2,0,2,1,6,2,0
Monaco,Mamadou Coulibaly,fr FRA,MF,20.0,0.1,1,0,0,1,0,0,0,,0,0,0,0,0,1,0,0
Nice,Marcin Bułka,pl POL,GK,24.0,34.0,0,0,0,0,0,0,1,0.0,1,0,0,0,0,0,16,6
Nice,Evann Guessand,ci CIV,FW,23.0,28.6,44,29,12,15,17,6,14,42.9,8,27,3,24,15,59,16,0
Nice,Hicham Boudaoui,dz ALG,MF,24.0,27.1,76,52,28,37,11,31,53,58.5,22,40,11,29,22,98,45,1
Nice,Jonathan Clauss,fr FRA,DF,31.0,25.7,52,35,27,19,6,28,56,50.0,28,25,2,23,48,100,68,3
Nice,Moïse Bombito,ca CAN,DF,24.0,24.4,37,25,22,12,3,24,35,68.6,11,35,19,16,18,55,121,7
Nice,Melvin Bard,fr FRA,DF,23.0,21.6,53,36,35,13,5,24,42,57.1,18,38,13,25,29,82,60,3
Nice,Youssouf Ndayishimiye,bi BDI,DF,25.0,21.5,40,21,25,14,1,16,27,59.3,11,35,19,16,21,61,117,4
Nice,Dante,br BRA,DF,40.0,21.9,32,15,17,13,2,15,29,51.7,14,29,14,15,34,66,74,1
Nice,Pablo Rosario,nl NED,MF,27.0,19.8,30,20,6,19,5,11,20,55.0,9,19,11,8,31,61,43,2
Nice,Mohamed Ali Cho,fr FRA,FW,20.0,18.2,13,9,4,5,4,4,12,33.3,8,17,1,16,5,18,8,0
Nice,Gaëtan Laborde,fr FRA,FW,30.0,20.5,19,13,9,8,2,9,22,40.9,13,16,4,12,6,25,20,0
Nice,Ali Abdi,tn TUN,DF,30.0,15.6,43,25,18,14,11,28,43,65.1,15,20,6,14,20,63,37,0
Nice,Tanguy Ndombele,fr FRA,MF,27.0,12.7,35,23,10,21,4,12,20,60.0,8,9,0,9,14,49,9,0
Nice,Jeremie Boga,ci CIV,MF,27.0,11.8,10,5,2,5,3,4,8,50.0,4,13,0,13,3,13,2,1
Nice,Badredine Bouanani,dz ALG,MF,19.0,12.3,11,4,4,4,3,6,18,33.3,12,16,3,13,11,22,4,0
Nice,Baptiste Santamaria,fr FRA,MF,29.0,10.4,20,10,10,7,3,13,22,59.1,9,14,3,11,18,38,19,1
Nice,Mohamed Abdelmoneim,eg EGY,DF,25.0,9.5,21,14,12,6,3,13,22,59.1,9,11,5,6,15,36,56,1
Nice,Sofiane Diop,fr FRA,MF,24.0,11.9,23,16,16,3,4,9,22,40.9,13,19,2,17,17,40,7,1
Nice,Antoine Mendy,sn SEN,DF,20.0,9.2,30,21,16,14,0,19,29,65.5,10,9,5,4,8,38,29,1
Nice,Tom Louchet,fr FRA,DF,21.0,8.7,27,17,17,5,5,17,23,73.9,6,12,4,8,18,45,20,0
Nice,Morgan Sanson,fr FRA,MF,29.0,2.6,6,3,2,4,0,1,3,33.3,2,3,0,3,4,10,2,0
Nice,Youssoufa Moukoko,de GER,FW,19.0,2.3,3,2,2,1,0,1,2,50.0,1,2,0,2,0,3,0,0
Nice,Yael Nandjou,fr FRA,DF,19.0,1.7,4,1,2,1,1,4,8,50.0,4,4,1,3,4,8,7,0
Nice,Bilal Brahimi,dz ALG,MF,24.0,0.9,0,0,0,0,0,0,0,,0,1,0,1,0,0,2,0
Nice,Terem Moffi,ng NGA,FW,25.0,0.6,0,0,0,0,0,0,0,,0,0,0,0,0,0,0,0
Nice,Amidou Doumbouya,fr FRA,DF,16.0,0.5,1,1,0,0,1,1,1,100.0,0,3,1,2,1,2,1,0
Nice,Victor Orakpo,ng NGA,FW,18.0,0.4,0,0,0,0,0,0,0,,0,0,0,0,0,0,0,0
Nice,Jordan Lotomba,ch SUI,MF,25.0,0.4,0,0,0,0,0,0,0,,0,0,0,0,0,0,1,0
Nice,Issiaga Camara,gn GUI,MF,19.0,0.2,2,1,0,2,0,0,1,0.0,1,0,0,0,3,5,0,0
Nice,Rareş Ilie,ro ROU,MF,21.0,0.1,1,1,1,0,0,1,1,100.0,0,0,0,0,0,1,0,0
Nice,Bernard Nguene,cm CMR,FW,17.0,0.1,0,0,0,0,0,0,0,,0,0,0,0,0,0,0,0
Lille,Lucas Chevalier,fr FRA,GK,22.0,34.0,3,2,3,0,0,3,4,75.0,1,0,0,0,0,3,13,4
Lille,Bafodé Diakité,fr FRA,DF,23.0,30.7,31,18,17,11,3,18,26,69.2,8,30,17,13,27,58,99,5
Lille,Alexsandro Ribeiro,br BRA,DF,24.0,30.0,32,19,18,13,1,20,30,66.7,10,23,13,10,27,59,143,3
Lille,Benjamin André,fr FRA,MF,33.0,29.9,103,57,31,60,12,54,96,56.3,42,42,6,36,48,151,56,0
Lille,Jonathan David,ca CAN,FW,24.0,28.5,24,8,3,12,9,9,21,42.9,12,13,2,11,7,31,10,1
Lille,Thomas Meunier,be BEL,DF,32.0,21.5,53,38,32,15,6,33,49,67.3,16,21,8,13,34,87,64,0
Lille,Hákon Arnar Haraldsson,is ISL,MF,21.0,19.7,36,16,9,17,10,16,33,48.5,17,10,2,8,8,44,6,0
Lille,Gabriel Gudmundsson,se SWE,DF,25.0,20.0,36,25,15,15,6,23,36,63.9,13,19,7,12,17,53,41,3
Lille,Aïssa Mandi,dz ALG,DF,32.0,19.3,31,17,12,15,4,16,22,72.7,6,23,11,12,15,46,54,0
Lille,André Gomes,pt POR,MF,31.0,14.3,27,13,9,11,7,11,31,35.5,20,7,1,6,6,33,11,2
Lille,Ngal'Ayel Mukau,cd COD,MF,19.0,13.3,33,18,9,22,2,17,29,58.6,12,14,0,14,15,48,22,0
Lille,Mitchel Bakker,nl NED,"FW,DF",24.0,12.7,23,13,6,11,6,10,19,52.6,9,10,1,9,12,35,15,0
Lille,Matias Fernandez-Pardo,be BEL,FW,19.0,11.9,12,9,3,6,3,6,12,50.0,6,9,0,9,3,15,6,0
Lille,Rémy Cabella,fr FRA,FW,34.0,11.3,39,19,16,13,10,19,33,57.6,14,10,1,9,8,47,5,0
Lille,Edon Zhegrova,xk KVX,FW,25.0,10.9,5,2,3,0,2,2,7,28.6,5,8,0,8,4,9,1,0
Lille,Ayyoub Bouaddi,fr FRA,MF,16.0,12.9,50,31,21,21,8,19,32,59.4,13,12,3,9,10,60,12,1
Lille,Osame Sahraoui,ma MAR,FW,23.0,14.5,13,9,4,4,5,3,8,37.5,5,14,1,13,7,20,8,1
Lille,Ismaily,br BRA,DF,34.0,10.1,33,17,17,12,4,17,26,65.4,9,15,1,14,13,46,49,0
Lille,Angel Gomes,eng ENG,MF,23.0,8.2,10,6,4,4,2,2,12,16.7,10,0,0,0,0,10,2,0
Lille,Chuba Akpom,eng ENG,FW,28.0,7.2,8,5,0,4,4,2,6,33.3,4,9,0,9,0,8,3,0
Lille,Tiago Santos,pt POR,DF,22.0,4.5,12,7,4,5,3,6,9,66.7,3,2,0,2,2,14,4,0
Lille,Mohamed Lamine Bayo,gn GUI,FW,26.0,3.5,1,1,0,0,1,1,1,100.0,0,0,0,0,0,1,4,0
Lille,Nabil Bentaleb,dz ALG,MF,29.0,3.7,4,3,2,0,2,3,7,42.9,4,5,0,5,5,9,7,2
Lille,Ethan Mbappé,fr FRA,MF,17.0,2.5,6,2,3,2,1,0,4,0.0,4,6,0,6,1,7,0,0
Lille,Younes Lachaab,fr FRA,MF,19.0,0.1,1,1,0,0,1,1,1,100.0,0,0,0,0,1,2,0,0
Lille,Ousmane Toure,fr FRA,DF,19.0,0.1,0,0,0,0,0,0,0,,0,0,0,0,1,1,2,0
Lille,Aaron Malouda,fr FRA,FW,18.0,0.0,0,0,0,0,0,0,0,,0,0,0,0,0,0,0,0
Lyon,Lucas Perri,br BRA,GK,26.0,33.0,1,1,1,0,0,0,4,0.0,4,1,0,1,0,1,22,1
Lyon,Moussa Niakhate,sn SEN,DF,28.0,30.3,47,27,37,8,2,24,32,75.0,8,26,17,9,25,72,143,3
Lyon,Clinton Mata,ao ANG,DF,31.0,26.4,41,29,23,14,4,28,36,77.8,8,26,17,9,46,87,72,3
Lyon,Corentin Tolisso,fr FRA,MF,29.0,26.0,57,25,21,26,10,34,65,52.3,31,52,13,39,22,79,41,1
Lyon,Nemanja Matić,rs SRB,MF,35.0,22.5,42,29,15,21,6,23,41,56.1,18,21,9,12,18,60,31,1
Lyon,Alexandre Lacazette,fr FRA,FW,33.0,23.0,13,6,3,7,3,5,16,31.3,11,13,3,10,8,21,7,0
Lyon,Rayan Cherki,fr FRA,FW,20.0,22.8,15,12,3,8,4,6,28,21.4,22,6,0,6,7,22,6,0
Lyon,Nicolás Tagliafico,ar ARG,DF,31.0,21.2,57,37,24,22,11,29,48,60.4,19,25,7,18,36,93,55,0
Lyon,Ainsley Maitland-Niles,eng ENG,DF,26.0,22.1,71,44,30,26,15,48,76,63.2,28,28,4,24,25,96,61,6
Lyon,Jordan Veretout,fr FRA,MF,31.0,17.4,30,14,14,14,2,17,40,42.5,23,17,3,14,5,35,23,1
Lyon,Duje Ćaleta-Car,hr CRO,DF,27.0,17.6,20,12,11,9,0,10,19,52.6,9,33,25,8,17,37,97,2
Lyon,Malick Fofana,be BEL,FW,19.0,17.8,22,11,8,11,3,8,17,47.1,9,12,0,12,8,30,6,0
Lyon,Georges Mikautadze,ge GEO,FW,23.0,16.2,7,6,1,3,3,3,9,33.3,6,11,0,11,4,11,6,0
Lyon,Tanner Tessmann,us USA,MF,22.0,13.8,25,15,11,10,4,12,25,48.0,13,13,7,6,19,44,29,1
Lyon,Ernest Nuamah,gh GHA,FW,20.0,11.8,21,11,15,4,2,12,27,44.4,15,9,1,8,8,29,8,1
Lyon,Abner,br BRA,DF,24.0,12.2,29,20,12,10,7,21,32,65.6,11,15,2,13,5,34,41,0
Lyon,Sael Kumbedi,fr FRA,DF,19.0,10.6,28,14,11,13,4,14,20,70.0,6,11,3,8,8,36,32,1
Lyon,Thiago Almada,ar ARG,MF,23.0,10.6,14,8,7,5,2,7,21,33.3,14,2,0,2,7,21,6,3
Lyon,Saïd Benrahma,dz ALG,FW,28.0,8.2,9,5,4,4,1,3,10,30.0,7,6,0,6,3,12,2,0
Lyon,Maxence Caqueret,fr FRA,MF,24.0,6.4,21,11,5,11,5,4,22,18.2,18,12,2,10,7,28,2,0
Lyon,Gift Orban,ng NGA,"FW,DF",22.0,2.1,0,0,0,0,0,0,1,0.0,1,0,0,0,0,0,0,0
Lyon,Rémy Descamps,fr FRA,GK,28.0,1.0,0,0,0,0,0,0,0,,0,0,0,0,0,0,0,0
Lyon,Wilfried Zaha,ci CIV,FW,31.0,0.8,1,1,1,0,0,1,2,50.0,1,3,0,3,1,2,0,0
Lyon,Orel Mangala,be BEL,MF,26.0,0.8,1,0,0,0,1,0,1,0.0,1,2,0,2,0,1,1,0
Lyon,Mama Samba Baldé,gw GNB,FW,28.0,0.4,2,2,0,2,0,0,0,,0,0,0,0,1,3,1,0
Lyon,Alejandro Rodriguez,pt POR,MF,16.0,0.2,0,0,0,0,0,0,0,,0,0,0,0,0,0,0,0
Lyon,Paul Akouokou,ci CIV,MF,26.0,0.2,1,0,0,1,0,0,0,,0,0,0,0,1,2,0,1
Lyon,Mahamadou Diawara,fr FRA,MF,19.0,0.2,1,0,0,1,0,1,3,33.3,2,2,0,2,0,1,0,0
Lyon,Warmed Omari,km COM,DF,24.0,0.1,0,0,0,0,0,0,0,,0,0,0,0,0,0,1,0
Lyon,Téo Barisic,fr FRA,DF,19.0,0.0,0,0,0,0,0,0,0,,0,0,0,0,0,0,1,0
Lyon,Adryelson,br BRA,DF,26.0,0.0,0,0,0,0,0,0,0,,0,0,0,0,1,1,1,0
Strasbourg,Andrey Santos,br BRA,MF,20.0,31.7,110,74,47,51,12,51,87,58.6,36,46,14,32,32,142,67,1
Strasbourg,Đorđe Petrović,rs SRB,GK,24.0,31.0,1,1,1,0,0,0,0,,0,0,0,0,0,1,24,1
Strasbourg,Ismaël Doukouré,fr FRA,DF,21.0,29.4,40,22,19,18,3,17,25,68.0,8,31,14,17,25,65,102,3
Strasbourg,Guela Doué,ci CIV,DF,21.0,30.2,65,45,40,15,10,37,54,68.5,17,38,6,32,34,99,154,1
Strasbourg,Diego Moreira,pt POR,DF,19.0,28.7,44,28,17,19,8,24,50,48.0,26,23,4,19,35,79,65,0
Strasbourg,Dilane Bakwa,fr FRA,MF,21.0,27.9,26,14,11,8,7,12,24,50.0,12,21,1,20,15,41,27,0
Strasbourg,Mamadou Sarr,fr FRA,DF,18.0,26.3,37,21,24,11,2,16,24,66.7,8,26,20,6,25,62,117,3
Strasbourg,Habib Diarra,sn SEN,MF,20.0,26.2,22,13,6,13,3,8,20,40.0,12,22,6,16,13,35,46,3
Strasbourg,Emanuel Emegha,nl NED,FW,21.0,25.6,6,6,1,2,3,2,6,33.3,4,18,5,13,1,7,30,0
Strasbourg,Sebastian Nanasi,se SWE,MF,22.0,23.7,20,13,6,12,2,8,22,36.4,14,24,3,21,7,27,18,0
Strasbourg,Félix Lemaréchal,fr FRA,MF,20.0,19.9,35,24,13,17,5,14,29,48.3,15,35,4,31,14,49,19,0
Strasbourg,Valentín Barco,ar ARG,MF,20.0,13.0,36,22,24,10,2,22,30,73.3,8,8,3,5,13,49,28,1
Strasbourg,Saidou Sow,gn GUI,DF,22.0,11.3,9,5,6,3,0,6,12,50.0,6,15,9,6,15,24,37,2
Strasbourg,Abakar Sylla,ci CIV,DF,21.0,10.6,27,15,14,11,2,15,17,88.2,2,18,10,8,11,38,63,0
Strasbourg,Sekou Mara,fr FRA,FW,22.0,8.6,9,6,0,5,4,3,9,33.3,6,11,0,11,3,12,3,0
Strasbourg,Andrew Omobamidele,ie IRL,DF,22.0,6.0,7,4,4,3,0,2,5,40.0,3,12,8,4,8,15,41,0
Strasbourg,Guimissongui Ouattara,fr FRA,DF,18.0,5.3,6,4,3,1,2,3,5,60.0,2,10,0,10,9,15,12,2
Strasbourg,Samuel Amo-Ameyaw,eng ENG,DF,18.0,3.6,5,3,3,2,0,2,9,22.2,7,3,0,3,3,8,2,0
Strasbourg,Karl-Johan Johnsson,se SWE,GK,34.0,3.0,0,0,0,0,0,0,1,0.0,1,0,0,0,0,0,3,0
Strasbourg,Caleb Wiley,us USA,DF,19.0,3.0,1,0,0,1,0,0,1,0.0,1,3,1,2,4,5,5,0
Strasbourg,Junior Mwanga,fr FRA,MF,21.0,3.3,17,9,9,7,1,5,9,55.6,4,2,0,2,2,19,2,0
Strasbourg,Marvin Senaya,tg TOG,DF,23.0,2.5,8,3,5,2,1,6,12,50.0,6,6,2,4,7,15,12,0
Strasbourg,Jérémy Sebas,mq MTQ,FW,21.0,2.1,3,2,1,1,1,2,3,66.7,1,2,0,2,0,3,4,0
Strasbourg,Pape Daouda Diongue,sn SEN,MF,nan,0.9,2,0,1,1,0,1,2,50.0,1,0,0,0,3,5,2,0
Strasbourg,Eduard Sobol,ua UKR,DF,29.0,1.1,0,0,0,0,0,0,2,0.0,2,2,1,1,2,2,14,0
Strasbourg,Óscar Perea,co COL,MF,18.0,0.2,0,0,0,0,0,0,0,,0,0,0,0,0,0,0,0
Strasbourg,Milos Lukovic,rs SRB,FW,18.0,0.1,0,0,0,0,0,0,0,,0,0,0,0,0,0,0,0
Strasbourg,Nordine Kandil,fr FRA,MF,22.0,0.1,0,0,0,0,0,0,0,,0,0,0,0,0,0,1,0
Strasbourg,Thomas Delaine,fr FRA,DF,32.0,0.1,1,1,1,0,0,1,1,100.0,0,0,0,0,1,2,1,0
Strasbourg,Karol Fila,pl POL,MF,26.0,0.1,0,0,0,0,0,0,0,,0,0,0,0,0,0,0,0
Lens,Adrien Thomasson,fr FRA,MF,30.0,29.2,90,47,42,25,23,52,95,54.7,43,48,3,45,19,109,28,2
Lens,Facundo Medina,ar ARG,DF,25.0,28.3,44,29,22,18,4,24,42,57.1,18,30,10,20,32,76,70,0
Lens,Andy Diouf,fr FRA,MF,21.0,24.9,37,26,10,22,5,16,40,40.0,24,24,1,23,15,52,18,2
Lens,Jonathan Gradit,fr FRA,DF,31.0,23.5,44,23,22,19,3,23,40,57.5,17,27,12,15,25,69,122,2
Lens,Florian Sotoca,fr FRA,FW,33.0,20.1,22,13,3,8,11,12,22,54.5,10,12,2,10,14,36,25,0
Lens,Deiver Machado,co COL,DF,30.0,20.1,36,26,14,14,8,17,30,56.7,13,20,4,16,16,52,34,2
Lens,Neil El Aynaoui,fr FRA,MF,23.0,17.7,39,21,18,15,6,12,34,35.3,22,34,8,26,30,69,29,0
Lens,M'Bala Nzola,ao ANG,FW,27.0,16.3,5,4,0,1,4,3,9,33.3,6,9,1,8,5,10,7,0
Lens,Anass Zaroury,ma MAR,FW,23.0,15.7,23,17,6,12,5,9,26,34.6,17,9,0,9,6,29,15,0
Lens,Przemysław Frankowski,pl POL,DF,29.0,15.4,32,21,17,10,5,19,30,63.3,11,10,2,8,19,51,28,0
Lens,Malang Sarr,fr FRA,DF,25.0,15.4,21,13,12,6,3,16,27,59.3,11,18,9,9,22,43,63,3
Lens,Brice Samba,fr FRA,GK,30.0,15.0,0,0,0,0,0,0,0,,0,0,0,0,1,1,6,2
Lens,Mathew Ryan,au AUS,GK,32.0,14.0,1,0,1,0,0,1,2,50.0,1,0,0,0,1,2,2,2
Lens,Ruben Aguilar,fr FRA,DF,31.0,12.6,34,18,17,12,5,24,39,61.5,15,25,3,22,13,47,23,0
Lens,Kevin Danso,at AUT,DF,25.0,12.0,19,7,12,5,2,12,16,75.0,4,25,19,6,20,39,62,1
Lens,Goduine Koyalipou,cf CTA,FW,24.0,10.0,3,2,0,3,0,1,1,100.0,0,4,0,4,1,4,8,0
Lens,Angelo Fulgini,fr FRA,MF,27.0,11.7,14,10,6,4,4,6,16,37.5,10,11,1,10,2,16,3,0
Lens,Abdukodir Khusanov,uz UZB,DF,20.0,10.8,15,11,9,5,1,7,11,63.6,4,17,11,6,26,41,57,0
Lens,Wesley Saïd,fr FRA,FW,29.0,10.2,16,11,3,10,3,6,13,46.2,7,6,0,6,2,18,2,0
Lens,Juma Bah,sl SLE,DF,18.0,7.6,16,10,6,10,0,5,7,71.4,2,10,7,3,17,33,47,1
Lens,Jhoanner Chávez,ec ECU,DF,22.0,6.7,9,5,4,4,1,2,7,28.6,5,10,1,9,6,15,13,0
Lens,Nampalys Mendy,sn SEN,MF,32.0,6.6,15,8,4,7,4,6,14,42.9,8,8,2,6,9,24,8,0
Lens,Rémy Labeau Lascary,gp GLP,FW,21.0,7.1,16,10,7,6,3,5,11,45.5,6,5,0,5,1,17,7,0
Lens,Hervé Koffi,bf BFA,GK,27.0,5.0,1,1,1,0,0,1,1,100.0,0,0,0,0,0,1,5,0
Lens,David Costa,pt POR,MF,23.0,3.9,2,0,1,1,0,1,4,25.0,3,5,1,4,1,3,0,0
Lens,Tom Pouilly,fr FRA,DF,21.0,3.1,9,6,5,1,3,5,10,50.0,5,5,1,4,4,13,11,0
Lens,Kyllian Antonio,fr FRA,DF,16.0,1.6,3,2,2,0,1,1,3,33.3,2,3,0,3,3,6,3,1
Lens,Hamzat Ojediran,ng NGA,MF,20.0,4.6,28,15,12,13,3,7,19,36.8,12,10,2,8,10,38,7,0
Lens,Jeremy Agbonifo,se SWE,FW,18.0,3.3,7,6,6,0,1,3,7,42.9,4,2,1,1,1,8,0,1
Lens,Martin Satriano,uy URU,"FW,DF",23.0,1.0,3,1,1,1,1,3,3,100.0,0,0,0,0,0,3,2,0
Lens,Rayan Fofana,fr FRA,FW,18.0,0.3,2,2,1,1,0,0,0,,0,0,0,0,0,2,0,0
Lens,Gabin Capuano,fr FRA,FW,18.0,0.1,0,0,0,0,0,0,0,,0,0,0,0,0,0,0,0
Lens,Kembo Diliwidi,fr FRA,DF,18.0,0.0,0,0,0,0,0,0,0,,0,0,0,0,0,0,0,0
Brest,Marco Bizot,nl NED,GK,33.0,32.0,2,1,2,0,0,1,2,50.0,1,0,0,0,0,2,33,0
Brest,Mahdi Camara,fr FRA,MF,26.0,29.7,71,40,16,38,17,24,46,52.2,22,40,5,35,33,104,29,0
Brest,Kenny Lala,mg MAD,DF,32.0,29.8,66,42,36,23,7,38,57,66.7,19,25,9,16,25,91,75,2
Brest,Ludovic Ajorque,fr FRA,FW,30.0,27.9,26,19,3,12,11,10,32,31.3,22,20,5,15,6,32,26,0
Brest,Brendan Chardonnet,fr FRA,DF,29.0,26.9,45,33,28,14,3,25,40,62.5,15,45,28,17,29,74,169,2
Brest,Hugo Magnetti,fr FRA,MF,26.0,26.0,52,32,21,27,4,23,51,45.1,28,20,3,17,18,70,37,0
Brest,Massadio Haïdara,ml MLI,DF,31.0,18.7,27,16,16,9,2,13,29,44.8,16,18,2,16,26,53,73,0
Brest,Abdoulaye Niakhate Ndiaye,sn SEN,DF,22.0,19.0,49,33,36,12,1,25,37,67.6,12,29,17,12,11,60,144,3
Brest,Mathias Pereira Lage,pt POR,FW,27.0,17.6,37,24,16,13,8,18,39,46.2,21,17,2,15,20,57,20,2
Brest,Pierre Lees-Melou,fr FRA,MF,31.0,17.0,48,33,20,19,9,25,54,46.3,29,19,3,16,12,60,23,0
Brest,Julien Le Cardinal,fr FRA,DF,26.0,15.3,27,15,16,8,3,11,16,68.8,5,18,14,4,33,60,75,0
Brest,Romain Del Castillo,fr FRA,FW,28.0,14.1,31,22,9,13,9,19,32,59.4,13,16,0,16,6,37,5,0
Brest,Abdallah Sima,sn SEN,FW,23.0,13.9,15,11,2,5,8,4,11,36.4,7,9,1,8,1,16,9,0
Brest,Kamory Doumbia,ml MLI,MF,21.0,14.8,41,29,17,17,7,14,31,45.2,17,17,1,16,28,69,13,1
Brest,Mama Samba Baldé,gw GNB,FW,28.0,12.9,13,9,4,4,5,3,14,21.4,11,8,0,8,6,19,14,0
Brest,Edimilson Fernandes,ch SUI,MF,28.0,12.3,9,7,3,6,0,7,13,53.8,6,14,6,8,20,29,38,1
Brest,Romain Faivre,fr FRA,MF,26.0,10.1,13,10,4,5,4,5,10,50.0,5,8,0,8,4,17,3,1
Brest,Jordan Amavi,fr FRA,DF,30.0,8.8,24,17,10,11,3,15,21,71.4,6,10,2,8,7,31,18,0
Brest,Luc Zogbé,ci CIV,DF,19.0,7.1,32,18,17,11,4,18,26,69.2,8,11,2,9,14,46,22,1
Brest,Jonas Martin,fr FRA,MF,34.0,5.6,13,7,10,2,1,6,11,54.5,5,4,1,3,8,21,12,1
Brest,Soumaïla Coulibaly,fr FRA,DF,20.0,4.9,4,2,2,2,0,1,1,100.0,0,7,2,5,5,9,26,0
Brest,Ibrahim Salah,ma MAR,FW,22.0,4.0,4,2,1,1,2,1,6,16.7,5,2,0,2,2,6,0,0
Brest,Grégoire Coudert,fr FRA,GK,25.0,2.0,0,0,0,0,0,0,0,,0,0,0,0,0,0,1,0
Brest,Justin Bourgault,fr FRA,DF,18.0,1.4,2,1,1,1,0,0,0,,0,0,0,0,0,2,1,0
Brest,Jérémy Le Douaron,fr FRA,FW,26.0,1.1,1,0,0,0,1,0,1,0.0,1,1,0,1,0,1,0,0
Brest,Bradley Locko,fr FRA,DF,22.0,1.1,2,2,1,1,0,1,1,100.0,0,3,2,1,1,3,3,0
Brest,Hamidou Makalou,ml MLI,FW,18.0,0.4,0,0,0,0,0,0,0,,0,0,0,0,0,0,0,0
Brest,Axel Camblan,fr FRA,MF,20.0,0.3,1,1,0,0,1,1,2,50.0,1,1,0,1,0,1,0,0
Brest,Hianga Mananga Mbock,fr FRA,MF,24.0,0.2,0,0,0,0,0,0,0,,0,0,0,0,1,1,0,0
Brest,Sérigné Diop,sn SEN,FW,19.0,0.0,1,0,0,1,0,0,0,,0,1,0,1,0,1,0,0
Toulouse,Cristian Cásseres Jr.,ve VEN,MF,24.0,30.1,96,61,41,43,12,46,88,52.3,42,35,9,26,42,138,36,1
Toulouse,Aron Dønnum,no NOR,DF,26.0,30.0,56,35,25,24,7,31,55,56.4,24,29,4,25,28,84,37,1
Toulouse,Charlie Cresswell,eng ENG,DF,21.0,28.8,35,23,19,15,1,28,46,60.9,18,44,28,16,28,63,191,3
Toulouse,Guillaume Restes,fr FRA,GK,19.0,28.3,2,1,2,0,0,2,3,66.7,1,0,0,0,1,3,16,1
Toulouse,Mark McKenzie,us USA,DF,25.0,27.7,52,31,31,20,1,33,45,73.3,12,31,18,13,22,74,141,1
Toulouse,Vincent Sierro,ch SUI,MF,28.0,26.8,44,27,15,23,6,27,56,48.2,29,34,9,25,16,60,44,1
Toulouse,Yann Gboho,fr FRA,MF,23.0,26.1,31,18,7,15,9,14,35,40.0,21,20,0,20,6,37,4,1
Toulouse,Djibril Sidibé,fr FRA,DF,32.0,23.4,65,36,34,22,9,31,50,62.0,19,11,3,8,20,85,64,1
Toulouse,Gabriel Suazo,cl CHI,DF,26.0,24.1,59,39,25,22,12,30,72,41.7,42,27,3,24,36,95,40,1
Toulouse,Zakaria Aboukhlal,ma MAR,MF,24.0,21.3,22,13,7,8,7,4,23,17.4,19,16,1,15,6,28,9,0
Toulouse,Joshua King,no NOR,FW,32.0,18.8,11,11,4,4,3,5,12,41.7,7,10,3,7,6,17,19,0
Toulouse,Frank Magri,cm CMR,FW,24.0,17.0,8,2,1,6,1,3,8,37.5,5,16,2,14,4,12,11,0
Toulouse,Jaydee Canvot,fr FRA,DF,18.0,12.3,23,11,16,5,2,12,18,66.7,6,10,2,8,11,34,54,1
Toulouse,Shavy Babicka,ga GAB,MF,24.0,13.3,21,12,6,11,4,10,21,47.6,11,14,0,14,3,24,4,3
Toulouse,Waren Kamanzi,no NOR,DF,23.0,11.4,29,13,12,12,5,14,28,50.0,14,7,3,4,9,38,25,0
Toulouse,Rasmus Nicolaisen,dk DEN,DF,27.0,6.9,6,3,4,2,0,3,5,60.0,2,10,5,5,10,16,25,0
Toulouse,Ümit Akdag,ro ROU,DF,20.0,5.6,8,4,3,4,1,5,12,41.7,7,10,8,2,11,19,19,0
Toulouse,Kjetil Haug,no NOR,GK,26.0,5.5,0,0,0,0,0,0,0,,0,0,0,0,0,0,3,0
Toulouse,Rafik Messali,fr FRA,DF,21.0,5.1,15,8,6,6,3,7,8,87.5,1,9,1,8,10,25,12,0
Toulouse,Denis Genreau,au AUS,MF,25.0,2.5,7,5,4,1,2,4,8,50.0,4,3,0,3,3,10,4,0
Toulouse,Niklas Schmidt,de GER,MF,26.0,2.3,6,4,1,5,0,4,7,57.1,3,0,0,0,1,7,4,0
Toulouse,Miha Zajc,si SVN,MF,30.0,2.9,4,4,1,2,1,3,5,60.0,2,2,1,1,3,7,7,0
Toulouse,Noah Edjouma,fr FRA,MF,18.0,1.9,2,2,0,1,1,1,2,50.0,1,1,1,0,2,4,2,0
Toulouse,Logan Costa,cv CPV,DF,23.0,1.0,2,1,0,2,0,1,1,100.0,0,2,2,0,2,4,4,0
Toulouse,Álex Domínguez,es ESP,GK,26.0,0.2,0,0,0,0,0,0,0,,0,0,0,0,0,0,0,0
Toulouse,Edhy Zuliani,fr FRA,DF,19.0,0.1,0,0,0,0,0,0,0,,0,0,0,0,1,1,0,0
Toulouse,Naatan Skyttä,fi FIN,FW,22.0,0.1,1,0,0,0,1,0,0,,0,0,0,0,0,1,0,0
Auxerre,Donovan Léon,gf GUF,GK,31.0,32.0,0,0,0,0,0,0,3,0.0,3,2,0,2,0,0,26,1
Auxerre,Gaëtan Perrin,fr FRA,MF,28.0,30.1,49,26,22,12,15,21,48,43.8,27,10,0,10,12,61,4,1
Auxerre,Jubal,br BRA,DF,30.0,29.4,60,39,46,13,1,28,40,70.0,12,61,36,25,25,85,201,1
Auxerre,Clément Akpa,ci CIV,DF,22.0,27.7,55,34,36,12,7,31,46,67.4,15,38,14,24,42,97,141,2
Auxerre,Elisha Owusu,gh GHA,MF,26.0,26.2,73,41,29,39,5,31,48,64.6,17,33,9,24,42,115,35,1
Auxerre,Gideon Mensah,gh GHA,DF,26.0,25.4,68,45,37,21,10,33,66,50.0,33,27,4,23,50,118,83,0
Auxerre,Ki-Jana Hoever,nl NED,DF,22.0,23.8,51,38,26,16,9,30,54,55.6,24,33,3,30,21,72,70,1
Auxerre,Hamed Junior Traorè,ci CIV,MF,24.0,23.4,41,20,11,17,13,16,54,29.6,38,14,0,14,8,49,11,0
Auxerre,Lassine Sinayoko,ml MLI,FW,24.0,25.7,33,20,10,14,9,11,23,47.8,12,16,2,14,13,46,38,0
Auxerre,Sinaly Diomande,ci CIV,DF,23.0,21.6,39,19,20,18,1,28,40,70.0,12,37,18,19,30,69,100,2
Auxerre,Gabriel Osho,ng NGA,DF,25.0,18.4,23,15,17,3,3,13,20,65.0,7,32,19,13,12,35,87,0
Auxerre,Kévin Danois,fr FRA,MF,20.0,16.3,49,30,20,22,7,20,46,43.5,26,17,3,14,20,69,20,0
Auxerre,Han-Noah Massengo,fr FRA,MF,23.0,11.7,17,11,5,8,4,8,12,66.7,4,12,4,8,17,34,10,2
Auxerre,Theo Bair,ca CAN,FW,24.0,10.5,4,3,1,2,1,0,2,0.0,2,6,2,4,3,7,10,0
Auxerre,Paul Joly,fr FRA,DF,24.0,11.3,49,32,30,17,2,27,45,60.0,18,19,1,18,25,74,32,5
Auxerre,Ado Onaiwu,jp JPN,MF,28.0,10.7,11,7,2,6,3,4,14,28.6,10,12,0,12,3,14,12,0
Auxerre,Rayan Raveloson,mg MAD,MF,27.0,8.1,6,5,2,4,0,5,15,33.3,10,8,7,1,5,11,22,0
Auxerre,Assane Dioussé,sn SEN,MF,26.0,7.4,15,7,9,5,1,5,14,35.7,9,6,2,4,12,27,15,0
Auxerre,Florian Ayé,fr FRA,FW,27.0,6.4,2,2,0,0,2,0,2,0.0,2,7,0,7,7,9,6,0
Auxerre,Fredrik Oppegard,no NOR,DF,21.0,3.1,6,4,4,1,1,3,7,42.9,4,2,1,1,2,8,12,1
Auxerre,Théo De Percin,mq MTQ,GK,23.0,2.0,0,0,0,0,0,0,1,0.0,1,0,0,0,0,0,3,0
Auxerre,Rudy Matondo,fr FRA,MF,16.0,0.7,1,1,1,0,0,0,1,0.0,1,0,0,0,0,1,2,0
Auxerre,Lasso Coulibaly,ci CIV,FW,21.0,0.5,1,1,0,0,1,0,0,,0,0,0,0,0,1,0,0
Auxerre,Théo Pellenard,fr FRA,DF,30.0,0.5,3,2,2,1,0,1,3,33.3,2,1,0,1,0,3,3,0
Auxerre,Aristide Zossou,ci CIV,MF,19.0,0.2,0,0,0,0,0,0,0,,0,0,0,0,0,0,0,0
Auxerre,Eros Maddy,nl NED,DF,23.0,0.2,0,0,0,0,0,0,0,,0,0,0,0,0,0,0,0
Auxerre,Loïc N'Gatta,fr FRA,DF,20.0,0.1,1,1,0,1,0,1,2,50.0,1,1,0,1,0,1,1,0
Auxerre,Yoann Cissé,fr FRA,MF,19.0,0.1,0,0,0,0,0,0,0,,0,0,0,0,1,1,0,0
Auxerre,Ben Viadere,fr FRA,MF,18.0,0.1,0,0,0,0,0,0,0,,0,0,0,0,0,0,0,0
Rennes,Adrien Truffert,fr FRA,DF,22.0,30.6,61,36,27,21,13,32,48,66.7,16,44,6,38,27,88,56,1
Rennes,Arnaud Kalimuendo,fr FRA,FW,22.0,28.8,19,12,6,9,4,7,15,46.7,8,9,2,7,4,23,16,1
Rennes,Lorenz Assignon,tg TOG,DF,24.0,26.3,49,27,25,22,2,19,43,44.2,24,20,3,17,25,74,74,0
Rennes,Ludovic Blas,fr FRA,MF,26.0,25.6,38,25,9,12,17,23,42,54.8,19,16,2,14,13,51,11,0
Rennes,Azor Matusiwa,nl NED,MF,26.0,23.2,64,39,32,30,2,32,43,74.4,11,29,10,19,34,98,52,0
Rennes,Hans Hateboer,nl NED,DF,30.0,18.8,31,16,14,12,5,18,36,50.0,18,19,6,13,29,60,64,2
Rennes,Brice Samba,fr FRA,GK,30.0,17.0,2,1,2,0,0,1,2,50.0,1,0,0,0,0,2,12,3
Rennes,Steve Mandanda,fr FRA,GK,39.0,16.5,0,0,0,0,0,0,1,0.0,1,0,0,0,0,0,6,2
Rennes,Christopher Wooh,cm CMR,DF,22.0,16.2,36,19,21,13,2,18,27,66.7,9,22,8,14,23,59,63,0
Rennes,Lilian Brassier,fr FRA,DF,24.0,13.7,15,12,11,4,0,9,11,81.8,2,17,10,7,22,37,62,1
Rennes,Leo Skiri Østigård,no NOR,DF,24.0,13.7,20,18,16,4,0,15,22,68.2,7,12,10,2,15,35,81,1
Rennes,Jordan James,wls WAL,MF,20.0,13.2,30,19,8,18,4,16,30,53.3,14,14,1,13,14,44,17,1
Rennes,Djaoui Cissé,fr FRA,MF,20.0,12.6,33,18,12,15,6,16,26,61.5,10,29,4,25,13,46,11,1
Rennes,Amine Gouiri,dz ALG,MF,24.0,11.6,9,6,4,4,1,2,8,25.0,6,8,0,8,2,11,5,0
Rennes,Anthony Rouault,fr FRA,DF,23.0,10.8,12,8,10,2,0,4,4,100.0,0,13,11,2,8,20,65,0
Rennes,Jérémy Jacquet,fr FRA,DF,19.0,10.3,26,17,11,8,7,14,22,63.6,8,9,3,6,27,53,45,1
Rennes,Alidu Seidu,gh GHA,DF,24.0,9.0,22,18,14,6,2,12,15,80.0,3,13,6,7,14,36,17,0
Rennes,Seko Fofana,ci CIV,MF,29.0,9.4,11,7,4,6,1,2,7,28.6,5,7,1,6,7,18,7,0
Rennes,Albert Grønbaek,dk DEN,MF,23.0,9.1,21,11,10,7,4,10,28,35.7,18,9,1,8,4,25,6,0
Rennes,Glen Kamara,fi FIN,MF,28.0,7.4,23,11,10,11,2,11,17,64.7,6,7,0,7,7,30,7,0
Rennes,Mikayil Ngor Faye,sn SEN,DF,20.0,7.7,15,12,10,3,2,7,9,77.8,2,9,4,5,12,27,30,0
Rennes,Musa Al-Taamari,jo JOR,FW,27.0,6.4,4,1,1,1,2,0,4,0.0,4,5,0,5,2,6,2,0
Rennes,Mohamed Meité,fr FRA,FW,16.0,6.1,2,0,0,2,0,1,1,100.0,0,1,0,1,0,2,5,0
Rennes,Baptiste Santamaria,fr FRA,MF,29.0,5.4,11,4,7,3,1,6,11,54.5,5,10,4,6,12,23,7,0
Rennes,Ismaël Koné,ca CAN,MF,22.0,5.3,9,6,4,4,1,5,7,71.4,2,9,2,7,4,13,5,0
Rennes,Mahamadou Nagida,cm CMR,DF,19.0,4.8,8,6,4,3,1,4,5,80.0,1,3,0,3,9,17,6,0
Rennes,Jota,pt POR,FW,25.0,3.7,5,2,2,3,0,4,7,57.1,3,1,0,1,3,8,2,0
Rennes,Kazeem Olaigbe,be BEL,MF,21.0,3.4,6,4,3,3,0,3,6,50.0,3,3,1,2,0,6,0,0
Rennes,Carlos Gómez,co COL,MF,21.0,4.2,8,6,3,4,1,3,9,33.3,6,6,0,6,2,10,2,0
Rennes,Kyogo Furuhashi,jp JPN,FW,29.0,1.4,2,2,1,1,0,1,1,100.0,0,0,0,0,0,2,0,0
Rennes,Benjamin Bourigeaud,fr FRA,MF,30.0,0.9,1,0,0,1,0,0,2,0.0,2,2,1,1,2,3,1,0
Rennes,Henrik Meister,dk DEN,FW,20.0,0.7,2,0,0,2,0,0,0,,0,4,0,4,1,3,0,0
Rennes,Naouirou Ahamada,fr FRA,MF,22.0,0.6,0,0,0,0,0,0,0,,0,0,0,0,2,2,2,0
Rennes,Gauthier Gallon,fr FRA,GK,31.0,0.5,0,0,0,0,0,0,0,,0,0,0,0,0,0,0,0
Rennes,Ayanda Sishuba,be BEL,FW,19.0,0.0,1,0,1,0,0,1,1,100.0,0,0,0,0,0,1,0,0
Nantes,Matthis Abline,fr FRA,FW,21.0,31.0,11,5,2,4,5,3,9,33.3,6,15,1,14,4,15,36,1
Nantes,Moses Simon,ng NGA,FW,29.0,29.2,20,14,4,7,9,7,22,31.8,15,11,0,11,12,32,13,0
Nantes,Jean-Charles Castelletto,cm CMR,DF,29.0,29.1,34,17,17,15,2,17,27,63.0,10,27,18,9,25,59,151,0
Nantes,Pedro Chirivella,es ESP,MF,27.0,26.3,44,29,23,16,5,19,42,45.2,23,25,4,21,19,63,45,0
Nantes,Douglas,br BRA,MF,27.0,25.7,69,42,29,31,9,26,44,59.1,18,51,11,40,32,101,47,0
Nantes,Kelvin Amian,fr FRA,DF,26.0,24.1,55,31,40,14,1,29,35,82.9,6,18,11,7,13,68,85,0
Nantes,Johann Lepenant,fr FRA,MF,21.0,22.9,68,33,30,27,11,32,71,45.1,39,35,3,32,18,86,25,0
Nantes,Nicolas Cozza,fr FRA,DF,25.0,22.8,59,41,35,18,6,31,47,66.0,16,25,10,15,25,84,69,0
Nantes,Nicolas Pallois,fr FRA,DF,36.0,22.5,61,27,44,13,4,37,63,58.7,26,48,18,30,28,89,164,3
Nantes,Anthony Lopes,pt POR,GK,33.0,17.4,1,0,1,0,0,1,1,100.0,0,0,0,0,1,2,7,1
Nantes,Nathan Zeze,fr FRA,DF,19.0,16.8,38,22,22,16,0,23,33,69.7,10,22,9,13,23,61,120,1
Nantes,Sorba Thomas,wls WAL,FW,24.0,14.8,14,6,7,5,2,10,18,55.6,8,12,2,10,9,23,27,1
Nantes,Alban Lafont,fr FRA,GK,25.0,12.0,1,1,1,0,0,1,1,100.0,0,2,0,2,0,1,8,1
Nantes,Mostafa Mohamed,eg EGY,FW,26.0,14.0,18,9,6,8,4,4,12,33.3,8,10,2,8,10,28,27,0
Nantes,Marcus Coco,fr FRA,DF,28.0,10.6,27,21,15,9,3,16,31,51.6,15,16,5,11,11,38,46,0
Nantes,Saidou Sow,gn GUI,DF,22.0,8.9,17,11,13,4,0,6,10,60.0,4,19,12,7,13,30,46,1
Nantes,Louis Leroux,fr FRA,MF,18.0,9.1,25,18,10,12,3,16,22,72.7,6,22,2,20,8,33,19,1
Nantes,Jean-Kevin Duverne,ht HAI,DF,27.0,6.0,21,12,13,4,4,15,27,55.6,12,10,3,7,8,29,23,0
Nantes,Tino Kadewere,zw ZIM,MF,28.0,5.8,14,8,5,3,6,6,13,46.2,7,3,0,3,6,20,8,0
Nantes,Patrik Carlgren,se SWE,GK,32.0,4.6,0,0,0,0,0,0,0,,0,0,0,0,0,0,0,0
Nantes,Fabien Centonze,fr FRA,DF,28.0,3.0,8,4,5,2,1,4,6,66.7,2,4,1,3,2,10,17,0
Nantes,Florent Mollet,fr FRA,MF,32.0,2.7,2,2,1,1,0,1,1,100.0,0,2,0,2,1,3,4,0
Nantes,Francis Coquelin,fr FRA,MF,33.0,2.5,9,5,5,3,1,3,4,75.0,1,3,1,2,6,15,3,0
Nantes,Bahereba Guirassy,fr FRA,FW,17.0,3.9,12,8,6,3,3,7,13,53.8,6,10,0,10,1,13,4,0
Nantes,Jean-Philippe Gbamin,ci CIV,MF,28.0,2.4,2,1,0,2,0,1,4,25.0,3,5,2,3,3,5,2,0
Nantes,Ignatius Ganago,cm CMR,FW,25.0,2.7,1,1,0,1,0,1,2,50.0,1,3,1,2,4,5,2,0
Nantes,Meschak Elia,cd COD,FW,26.0,1.9,7,5,3,2,2,1,1,100.0,0,3,0,3,0,7,2,0
Nantes,Dehmaine Assoumani,fr FRA,MF,19.0,1.1,6,3,0,4,2,4,5,80.0,1,1,0,1,1,7,4,0
Nantes,Plamedi Nsingi,,MF,23.0,0.2,1,0,1,0,0,0,1,0.0,1,0,0,0,0,1,0,0
Nantes,Sékou Doucoure,fr FRA,DF,19.0,0.1,0,0,0,0,0,0,0,,0,0,0,0,0,0,3,0
Angers,Jordan Lefort,fr FRA,DF,30.0,34.0,52,30,42,9,1,30,44,68.2,14,56,37,19,32,84,206,3
Angers,Yahia Fofana,ci CIV,GK,23.0,33.0,0,0,0,0,0,0,2,0.0,2,0,0,0,1,1,25,2
Angers,Himad Abdelli,dz ALG,MF,24.0,31.7,48,32,13,20,15,15,48,31.3,33,24,1,23,26,74,28,2
Angers,Florent Hanin,dz ALG,DF,34.0,29.8,69,48,45,17,7,39,71,54.9,32,31,10,21,47,116,99,2
Angers,Jean-Eudes Aholou,ci CIV,MF,30.0,22.0,56,36,26,20,10,22,48,45.8,26,34,14,20,33,89,32,0
Angers,Carlens Arcus,ht HAI,DF,28.0,22.9,52,35,32,15,5,34,56,60.7,22,24,4,20,27,79,83,3
Angers,Jim Allevinah,ga GAB,FW,29.0,19.7,19,11,6,9,4,5,28,17.9,23,10,0,10,12,31,17,0
Angers,Farid El Melali,dz ALG,FW,27.0,21.2,28,16,15,6,7,13,35,37.1,22,19,1,18,16,44,12,1
Angers,Haris Belkebla,dz ALG,MF,30.0,20.0,56,38,38,15,3,26,45,57.8,19,30,9,21,35,91,46,1
Angers,Esteban Lepaul,fr FRA,FW,24.0,18.2,11,6,2,6,3,4,16,25.0,12,15,2,13,4,15,10,0
Angers,Yassin Belkhdim,fr FRA,MF,22.0,17.0,53,27,26,21,6,27,58,46.6,31,23,6,17,21,74,41,1
Angers,Abdoulaye Bamba,ci CIV,DF,34.0,16.8,22,12,17,4,1,14,19,73.7,5,14,8,6,19,41,79,0
Angers,Emmanuel Biumla,fr FRA,DF,19.0,14.8,19,12,14,5,0,12,18,66.7,6,18,8,10,8,27,84,1
Angers,Lilian Raolisoa,fr FRA,DF,24.0,14.7,41,24,24,13,4,17,38,44.7,21,11,2,9,15,56,45,0
Angers,Ibrahima Niane,sn SEN,FW,25.0,10.5,7,3,3,2,2,3,3,100.0,0,6,1,5,2,9,6,2
Angers,Zinedine Ferhat,dz ALG,FW,31.0,9.5,9,7,1,5,3,4,13,30.8,9,9,0,9,10,19,12,0
Angers,Jacques Ekomie,ga GAB,DF,20.0,7.8,22,14,9,10,3,8,12,66.7,4,16,5,11,4,26,14,0
Angers,Bamba Dieng,sn SEN,FW,24.0,5.9,4,1,1,2,1,0,2,0.0,2,2,0,2,0,4,3,0
Angers,Zinédine Ould Khaled,fr FRA,MF,24.0,3.8,9,7,5,3,1,2,13,15.4,11,6,1,5,2,11,12,0
Angers,Pierrick Capelle,fr FRA,MF,37.0,5.4,24,17,10,9,5,9,18,50.0,9,4,1,3,11,35,5,1
Angers,Sidiki Cherif,fr FRA,FW,17.0,3.6,5,5,1,3,1,3,4,75.0,1,4,1,3,0,5,0,1
Angers,Marius Courcoul,fr FRA,MF,17.0,3.5,5,2,3,2,0,2,5,40.0,3,4,0,4,5,10,9,0
Angers,Cédric Hountondji,bj BEN,DF,30.0,3.0,6,4,4,2,0,3,7,42.9,4,3,3,0,4,10,14,0
Angers,Ousmane Camara,fr FRA,DF,21.0,2.8,4,3,3,1,0,1,2,50.0,1,1,1,0,0,4,18,0
Angers,Melvin Zinga,fr FRA,GK,22.0,1.0,0,0,0,0,0,0,0,,0,0,0,0,0,0,1,0
Angers,Enzo Caumont,fr FRA,MF,20.0,0.4,1,1,0,1,0,1,2,50.0,1,1,1,0,1,2,1,0
Angers,Justin-Noël Kalumba,fr FRA,FW,19.0,0.3,0,0,0,0,0,0,0,,0,0,0,0,1,1,1,0
Angers,Prosper Peter,ng NGA,MF,16.0,0.3,2,1,0,2,0,0,0,,0,0,0,0,0,2,0,0
Angers,Lois Diony,fr FRA,FW,31.0,0.2,0,0,0,0,0,0,0,,0,0,0,0,0,0,0,0
Angers,Lanroy Machine,fr FRA,FW,18.0,0.1,0,0,0,0,0,0,0,,0,0,0,0,0,0,0,0
Le Havre,Gautier Lloris,fr FRA,DF,29.0,30.8,68,43,52,16,0,38,53,71.7,15,33,21,12,34,102,192,0
Le Havre,Loïc Nego,hu HUN,DF,33.0,27.4,58,35,37,16,5,41,64,64.1,23,17,3,14,29,87,82,0
Le Havre,Abdoulaye Touré,gn GUI,MF,30.0,25.9,61,34,31,21,9,33,59,55.9,26,36,19,17,34,95,42,5
Le Havre,Etienne Youte Kinkoue,fr FRA,DF,22.0,25.8,19,10,11,7,1,13,20,65.0,7,36,23,13,29,48,158,3
Le Havre,Yassine Kechta,ma MAR,MF,22.0,23.5,60,36,32,21,7,33,78,42.3,45,25,2,23,26,86,32,2
Le Havre,Josué Casimir,fr FRA,FW,22.0,22.3,37,26,15,15,7,9,18,50.0,9,19,0,19,7,44,35,1
Le Havre,Issa Soumaré,sn SEN,FW,23.0,21.2,25,14,8,10,7,13,49,26.5,36,19,4,15,16,41,32,0
Le Havre,Arthur Desmas,fr FRA,GK,30.0,18.0,0,0,0,0,0,0,1,0.0,1,0,0,0,0,0,9,1
Le Havre,Mathieu Gorgelin,fr FRA,GK,33.0,16.0,2,2,2,0,0,2,3,66.7,1,0,0,0,0,2,8,2
Le Havre,Arouna Sangante,sn SEN,DF,22.0,13.9,25,16,11,14,0,10,17,58.8,7,11,5,6,21,46,65,3
Le Havre,André Ayew,gh GHA,FW,34.0,16.3,18,10,3,7,8,7,13,53.8,6,9,2,7,3,21,21,1
Le Havre,Christopher Operi,ci CIV,DF,27.0,13.0,13,9,6,2,5,7,12,58.3,5,20,6,14,14,27,30,0
Le Havre,Timothee Pembele,fr FRA,DF,21.0,12.4,30,22,17,9,4,14,23,60.9,9,16,5,11,11,41,42,0
Le Havre,Oussama Targhalline,ma MAR,MF,22.0,11.1,19,14,12,3,4,5,12,41.7,7,14,7,7,19,38,14,2
Le Havre,Rassoul Ndiaye,sn SEN,MF,22.0,11.9,35,25,19,12,4,11,25,44.0,14,15,4,11,12,47,24,0
Le Havre,Junior Mwanga,fr FRA,MF,21.0,10.6,26,16,10,13,3,11,19,57.9,8,10,3,7,8,34,18,2
Le Havre,Koka,eg EGY,FW,31.0,9.6,4,1,1,3,0,0,4,0.0,4,3,0,3,4,8,6,1
Le Havre,Yanis Zouaoui,dz ALG,DF,30.0,10.9,20,10,10,8,2,11,15,73.3,4,15,2,13,8,28,43,0
Le Havre,Antoine Joujou,fr FRA,MF,21.0,10.5,16,11,10,4,2,9,15,60.0,6,15,3,12,9,25,19,0
Le Havre,Yoann Salmier,gf GUF,DF,31.0,8.9,14,7,9,4,1,10,13,76.9,3,12,8,4,10,24,59,0
Le Havre,Fodé Ballo-Touré,sn SEN,DF,27.0,6.6,8,7,3,4,1,5,9,55.6,4,8,3,5,4,12,27,0
Le Havre,Emmanuel Sabbi,us USA,FW,26.0,7.3,14,7,7,4,3,5,8,62.5,3,2,0,2,3,17,4,0
Le Havre,Mahamadou Diawara,fr FRA,MF,19.0,6.5,20,12,10,8,2,8,13,61.5,5,13,6,7,13,33,11,1
Le Havre,Daler Kuzyaev,ru RUS,MF,31.0,6.3,13,8,7,4,2,2,9,22.2,7,7,4,3,9,22,8,0
Le Havre,Ilyes Housni,fr FRA,FW,19.0,2.6,7,5,2,3,2,2,4,50.0,2,2,0,2,1,8,2,0
Le Havre,Steve Ngoura,fr FRA,FW,19.0,3.2,4,2,1,1,2,3,3,100.0,0,2,1,1,0,4,2,0
Le Havre,Samuel Grandsir,fr FRA,MF,27.0,0.9,5,5,0,3,2,2,3,66.7,1,2,0,2,0,5,0,0
Le Havre,Elysée Logbo,fr FRA,FW,20.0,0.3,0,0,0,0,0,0,0,,0,0,0,0,0,0,0,0
Le Havre,Mathéo Bodmer,fr FRA,MF,20.0,0.1,0,0,0,0,0,0,0,,0,0,0,0,0,0,1,0
Le Havre,Kandet Diawara,gn GUI,FW,24.0,0.0,0,0,0,0,0,0,0,,0,1,0,1,0,0,1,0
Le Havre,Alois Confais,fr FRA,MF,27.0,0.0,0,0,0,0,0,0,0,,0,0,0,0,0,0,0,0
Reims,Yehvann Diouf,fr FRA,GK,24.0,34.0,2,1,2,0,0,1,3,33.3,2,0,0,0,1,3,22,4
Reims,Valentin Atangana Edoa,fr FRA,MF,18.0,31.9,69,50,32,30,7,28,38,73.7,10,31,15,16,37,106,64,0
Reims,Junya Ito,jp JPN,FW,31.0,30.0,45,30,19,16,10,17,60,28.3,43,33,3,30,13,58,15,2
Reims,Keito Nakamura,jp JPN,FW,24.0,29.6,24,16,7,10,7,11,31,35.5,20,21,1,20,13,37,19,0
Reims,Sergio Akieme,es ESP,DF,26.0,28.1,34,23,30,3,1,22,36,61.1,14,26,9,17,17,51,97,4
Reims,Cédric Kipré,ci CIV,DF,27.0,24.3,42,30,30,11,1,29,39,74.4,10,42,27,15,32,74,162,2
Reims,Aurélio Buta,pt POR,DF,27.0,22.0,37,24,22,11,4,21,42,50.0,21,19,5,14,22,59,59,0
Reims,Joseph Okumu,ke KEN,DF,27.0,18.9,30,15,21,9,0,15,24,62.5,9,33,21,12,25,55,137,2
Reims,Oumar Diakité,ci CIV,FW,20.0,18.3,20,13,7,8,5,9,19,47.4,10,13,2,11,3,23,9,0
Reims,Marshall Munetsi,zw ZIM,MF,28.0,18.8,36,18,22,9,5,22,38,57.9,16,27,3,24,17,53,35,0
Reims,Amadou Koné,ml MLI,MF,19.0,14.5,49,32,32,16,1,22,35,62.9,13,18,4,14,19,68,38,2
Reims,Emmanuel Agbadou,ci CIV,DF,27.0,14.0,25,17,19,3,3,19,26,73.1,7,22,13,9,19,44,64,1
Reims,Mory Gbane,ci CIV,DF,23.0,12.5,20,11,16,4,0,13,24,54.2,11,12,10,2,18,38,90,1
Reims,Nhoa Sangui,fr FRA,DF,18.0,12.9,16,9,6,6,4,9,12,75.0,3,8,4,4,8,24,23,0
Reims,Hiroki Sekine,jp JPN,DF,21.0,9.9,9,7,6,2,1,7,17,41.2,10,22,11,11,5,14,51,1
Reims,Teddy Teuma,mt MLT,MF,30.0,8.4,18,10,6,6,6,7,25,28.0,18,12,2,10,12,30,8,1
Reims,Yaya Kader Fofana,ml MLI,MF,20.0,7.1,17,11,8,5,4,4,12,33.3,8,11,2,9,3,20,2,0
Reims,Jordan Pefok,us USA,FW,28.0,4.3,3,2,0,3,0,2,3,66.7,1,3,1,2,2,5,5,0
Reims,Mamadou Diakhon,fr FRA,FW,18.0,9.6,12,8,4,3,5,9,18,50.0,9,5,1,4,4,16,5,0
Reims,John Joe,ie IRL,MF,20.0,6.1,24,15,11,10,3,7,19,36.8,12,11,2,9,6,30,9,0
Reims,Hafiz Ibrahim,ng NGA,FW,18.0,4.4,3,2,0,1,2,0,5,0.0,5,4,2,2,2,5,6,0
Reims,Amine Salama,fr FRA,FW,24.0,4.2,3,2,0,2,1,0,3,0.0,3,2,1,1,1,4,0,0
Reims,Thibault De Smet,be BEL,DF,26.0,2.1,6,4,5,1,0,4,4,100.0,0,5,3,2,4,10,12,0
Reims,Ange Martial Tia,ml MLI,MF,17.0,1.9,4,3,1,2,1,2,6,33.3,4,3,0,3,2,6,4,0
Reims,Malcolm Jeng,se SWE,DF,19.0,1.2,0,0,0,0,0,0,0,,0,1,0,1,3,3,10,0
Reims,Abdoul Koné,fr FRA,DF,19.0,1.5,5,3,4,1,0,3,5,60.0,2,2,1,1,1,6,5,0
Reims,Gabriel Moscardo,br BRA,MF,18.0,0.9,3,1,2,1,0,1,3,33.3,2,3,1,2,0,3,1,0
Reims,Reda Khadra,de GER,MF,23.0,0.9,1,1,1,0,0,0,1,0.0,1,0,0,0,0,1,1,0
Reims,Niama Sissoko,ml MLI,FW,18.0,0.5,0,0,0,0,0,0,0,,0,1,0,1,0,0,0,0
Reims,Martin Adeline,fr FRA,MF,20.0,0.3,1,1,0,1,0,1,2,50.0,1,0,0,0,0,1,2,0
Reims,Eloge Zabi,ci CIV,DF,17.0,0.2,0,0,0,0,0,0,0,,0,0,0,0,0,0,1,0
Reims,Mohamed Daramy,dk DEN,FW,22.0,0.2,0,0,0,0,0,0,0,,0,0,0,0,0,0,1,0
Reims,Mohamed Bamba,ci CIV,MF,19.0,0.1,0,0,0,0,0,0,1,0.0,1,2,1,1,0,0,1,0
Reims,Ike Orazi,ie IRL,MF,17.0,0.0,0,0,0,0,0,0,0,,0,0,0,0,0,0,0,0
Saint Etienne,Gautier Larsonneur,fr FRA,GK,27.0,34.0,1,0,1,0,0,0,2,0.0,2,1,0,1,0,1,25,1
Saint Etienne,Zuriko Davitashvili,ge GEO,FW,23.0,31.0,22,14,9,7,6,15,49,30.6,34,20,0,20,14,36,14,0
Saint Etienne,Léo Pétrot,fr FRA,DF,27.0,29.3,62,39,38,19,5,34,51,66.7,17,50,27,23,42,104,103,1
Saint Etienne,Pierre Ekwah Elimby,fr FRA,MF,22.0,28.7,54,33,18,30,6,34,56,60.7,22,26,12,14,47,101,72,1
Saint Etienne,Mickael Nade,fr FRA,DF,25.0,25.6,59,43,40,19,0,28,36,77.8,8,37,19,18,33,92,132,8
Saint Etienne,Lucas Stassin,be BEL,FW,19.0,21.1,16,11,3,5,8,6,20,30.0,14,10,0,10,3,19,8,0
Saint Etienne,Dennis Appiah,fr FRA,DF,32.0,23.7,71,43,42,22,7,41,71,57.7,30,36,8,28,29,100,89,2
Saint Etienne,Dylan Batubinsika,cd COD,DF,28.0,22.4,26,13,19,6,1,13,22,59.1,9,23,14,9,39,65,140,3
Saint Etienne,Benjamin Bouchouari,ma MAR,MF,22.0,19.8,33,27,15,13,5,16,46,34.8,30,21,1,20,17,50,15,2
Saint Etienne,Florian Tardieu,fr FRA,MF,32.0,14.0,18,14,6,9,3,6,17,35.3,11,18,5,13,15,33,21,0
Saint Etienne,Irvin Cardona,fr FRA,FW,26.0,11.9,6,5,3,3,0,2,14,14.3,12,16,3,13,4,10,6,2
Saint Etienne,Aimen Moueffek,fr FRA,MF,23.0,11.7,20,12,3,11,6,10,23,43.5,13,20,7,13,5,25,26,1
Saint Etienne,Louis Mouton,fr FRA,MF,22.0,11.7,49,25,14,25,10,22,37,59.5,15,17,3,14,10,59,19,0
Saint Etienne,Yunis Abdelhamid,ma MAR,DF,36.0,11.5,17,11,15,2,0,10,16,62.5,6,26,18,8,14,31,57,1
Saint Etienne,Yvann Macon,fr FRA,DF,25.0,8.9,19,11,9,7,3,10,21,47.6,11,14,4,10,2,21,10,1
Saint Etienne,Mathis Amougou,fr FRA,MF,18.0,9.6,21,15,15,5,1,10,19,52.6,9,10,0,10,12,33,4,0
Saint Etienne,Maxime Bernauer,fr FRA,DF,26.0,8.5,9,9,5,2,2,5,8,62.5,3,7,3,4,5,14,44,1
Saint Etienne,Mathieu Cafaro,fr FRA,MF,27.0,8.2,10,7,4,4,2,4,15,26.7,11,7,1,6,7,17,3,0
Saint Etienne,Ibrahim Sissoko,ml MLI,FW,28.0,9.2,11,9,5,3,3,2,5,40.0,3,10,2,8,2,13,13,0
Saint Etienne,Augustine Boakye,gh GHA,FW,23.0,8.2,7,3,3,4,0,3,11,27.3,8,5,0,5,6,13,4,0
Saint Etienne,Pierre Cornud,fr FRA,DF,27.0,6.4,12,10,6,4,2,8,17,47.1,9,9,4,5,9,21,28,1
Saint Etienne,Ben Old,nz NZL,FW,21.0,5.9,7,5,3,3,1,3,11,27.3,8,8,1,7,2,9,2,0
Saint Etienne,Lamine Fomba,fr FRA,MF,26.0,2.4,8,6,2,5,1,2,7,28.6,5,7,1,6,4,12,5,1
Saint Etienne,Djylian N'Guessan,fr FRA,FW,15.0,2.0,6,4,5,1,0,2,5,40.0,3,1,0,1,0,6,1,0
Saint Etienne,Ibrahima Wadji,sn SEN,FW,29.0,3.9,7,6,3,3,1,3,7,42.9,4,1,0,1,1,8,0,0
Saint Etienne,Marwann Nzuzi,fr FRA,DF,20.0,1.4,2,2,1,0,1,1,2,50.0,1,0,0,0,2,4,6,0
Saint Etienne,Ayman Aiki,fr FRA,FW,19.0,1.4,3,3,1,2,0,1,1,100.0,0,1,0,1,1,4,0,0
Saint Etienne,Beres Owusu,fr FRA,DF,20.0,1.0,2,2,1,1,0,2,2,100.0,0,2,2,0,0,2,5,0
Saint Etienne,Igor Miladinović,rs SRB,FW,21.0,0.3,0,0,0,0,0,0,0,,0,0,0,0,1,1,1,0
Saint Etienne,Kévin Pedro,fr FRA,DF,18.0,0.1,3,0,2,1,0,3,3,100.0,0,1,0,1,2,5,1,0
Saint Etienne,Jibril Othman,tn TUN,FW,20.0,0.1,0,0,0,0,0,0,0,,0,0,0,0,0,0,0,0
Saint Etienne,Anthony Briançon,fr FRA,DF,29.0,0.0,0,0,0,0,0,0,0,,0,0,0,0,0,0,0,0
Montpellier,Benjamin Lecomte,fr FRA,GK,33.0,30.0,0,0,0,0,0,0,0,,0,0,0,0,0,0,18,2
Montpellier,Téji Savanier,fr FRA,MF,32.0,26.3,29,25,7,16,6,18,43,41.9,25,16,1,15,15,44,21,4
Montpellier,Modibo Sagnan,ml MLI,DF,25.0,23.8,57,35,38,16,3,26,44,59.1,18,24,13,11,29,86,110,5
Montpellier,Joris Chotard,fr FRA,MF,22.0,21.1,39,27,17,20,2,20,46,43.5,26,28,10,18,19,58,52,1
Montpellier,Enzo Tchato,cm CMR,DF,21.0,21.2,48,26,26,18,4,26,44,59.1,18,30,10,20,22,70,59,0
Montpellier,Becir Omeragic,ch SUI,DF,22.0,20.0,32,16,19,12,1,16,21,76.2,5,32,21,11,13,45,78,0
Montpellier,Jordan Ferri,fr FRA,MF,32.0,19.8,42,23,18,22,2,18,44,40.9,26,20,3,17,9,51,20,0
Montpellier,Rabby Nzingoula,cg CGO,MF,18.0,18.9,64,42,26,31,7,27,58,46.6,31,27,5,22,29,93,23,0
Montpellier,Tanguy Coulibaly,fr FRA,FW,23.0,16.6,32,24,13,15,4,14,33,42.4,19,18,2,16,11,43,3,1
Montpellier,Issiaga Sylla,gn GUI,DF,30.0,12.9,25,10,17,7,1,15,29,51.7,14,13,4,9,10,35,34,1
Montpellier,Falaye Sacko,ml MLI,DF,29.0,13.7,14,8,9,4,1,9,19,47.4,10,17,7,10,13,27,21,0
Montpellier,Arnaud Nordin,fr FRA,FW,26.0,13.0,24,15,6,16,2,11,21,52.4,10,12,0,12,5,29,7,0
Montpellier,Akor Adams,ng NGA,FW,24.0,12.0,4,3,1,2,1,3,4,75.0,1,2,1,1,1,5,5,1
Montpellier,Musa Al-Taamari,jo JOR,FW,27.0,12.4,14,10,4,5,5,8,15,53.3,7,2,0,2,3,17,3,2
Montpellier,Théo Sainte-Luce,fr FRA,DF,25.0,11.4,24,11,16,4,4,16,33,48.5,17,16,4,12,12,36,33,1
Montpellier,Wahbi Khazri,tn TUN,FW,33.0,12.5,25,18,5,16,4,8,21,38.1,13,13,1,12,5,30,7,0
Montpellier,Khalil Fayad,fr FRA,MF,20.0,11.5,31,16,12,17,2,15,28,53.6,13,18,1,17,10,41,15,1
Montpellier,Yael Mouanga,fr FRA,DF,19.0,10.5,14,8,9,3,2,7,9,77.8,2,16,8,8,10,24,50,0
Montpellier,Boubakar Kouyaté,ml MLI,DF,27.0,8.4,22,17,16,6,0,11,19,57.9,8,17,11,6,12,34,54,0
Montpellier,Lucas Mincarelli,fr FRA,DF,20.0,8.0,17,10,6,9,2,6,13,46.2,7,8,5,3,9,26,27,0
Montpellier,Andy Delort,dz ALG,FW,32.0,6.8,4,3,1,2,1,1,2,50.0,1,3,1,2,0,4,3,0
Montpellier,Nikola Maksimović,rs SRB,DF,32.0,6.5,9,5,6,3,0,6,7,85.7,1,5,4,1,6,15,30,1
Montpellier,Bamo Meïté,ci CIV,DF,22.0,4.8,5,3,2,1,2,1,2,50.0,1,3,3,0,4,9,14,3
Montpellier,Nicolas Pays,fr FRA,FW,20.0,5.0,13,6,3,4,6,4,8,50.0,4,1,0,1,4,17,2,0
Montpellier,Junior Ndiaye,fr FRA,FW,19.0,4.9,3,2,2,1,0,1,4,25.0,3,2,1,1,0,3,2,0
Montpellier,Dimitry Bertaud,cd COD,GK,26.0,4.0,0,0,0,0,0,0,0,,0,0,0,0,0,0,2,0
Montpellier,Wilfried Ndollo,cm CMR,DF,19.0,4.5,6,5,4,1,1,4,8,50.0,4,9,1,8,7,13,11,0
Montpellier,Othmane Maamma,ma MAR,FW,18.0,4.0,3,1,2,1,0,1,4,25.0,3,4,0,4,1,4,2,1
Montpellier,Birama Touré,ml MLI,MF,32.0,3.3,8,5,5,2,1,4,6,66.7,2,3,2,1,6,14,7,0
Montpellier,Stefan Džodić,rs SRB,DF,19.0,2.7,8,5,3,5,0,5,8,62.5,3,5,4,1,5,13,10,1
Montpellier,Théo Chennahi,fr FRA,DF,19.0,2.0,6,3,3,3,0,4,7,57.1,3,3,0,3,2,8,6,0
Montpellier,Yanis Issoufou,fr FRA,MF,17.0,0.9,6,4,4,1,1,3,5,60.0,2,1,0,1,0,6,1,0
Montpellier,Gabriel Bares,ch SUI,MF,23.0,0.6,2,2,2,0,0,1,2,50.0,1,0,0,0,1,3,3,0
Montpellier,Axel Gueguin,fr FRA,FW,19.0,0.3,1,1,0,1,0,1,1,100.0,0,0,0,0,0,1,0,0
Montpellier,Simon Cara,fr FRA,MF,19.0,0.1,0,0,0,0,0,0,0,,0,0,0,0,0,0,0,0
Napoli,Amir Rrahmani,xk KVX,DF,30.0,37.9,39,31,19,19,1,16,25,64.0,9,43,26,17,27,66,179,2
Napoli,Giovanni Di Lorenzo,it ITA,DF,30.0,37.0,66,44,35,25,6,42,65,64.6,23,19,6,13,31,97,85,1
Napoli,Romelu Lukaku,be BEL,FW,31.0,31.9,4,2,0,2,2,1,4,25.0,3,7,2,5,1,5,17,0
Napoli,Alex Meret,it ITA,GK,27.0,33.4,0,0,0,0,0,0,0,,0,1,0,1,0,0,16,0
Napoli,Matteo Politano,it ITA,FW,30.0,31.5,29,15,17,11,1,15,43,34.9,28,21,1,20,13,42,50,1
Napoli,Scott McTominay,sct SCO,MF,27.0,32.7,43,25,12,27,4,18,36,50.0,18,22,5,17,24,67,51,0
Napoli,Andre-Frank Zambo Anguissa,cm CMR,MF,28.0,31.8,42,26,8,28,6,15,34,44.1,19,24,6,18,35,77,40,1
Napoli,Stanislav Lobotka,sk SVK,MF,29.0,29.4,47,30,16,21,10,19,31,61.3,12,29,11,18,21,68,57,1
Napoli,Mathías Olivera,uy URU,DF,26.0,26.4,63,35,31,25,7,32,53,60.4,21,36,12,24,28,91,74,1
Napoli,Alessandro Buongiorno,it ITA,DF,25.0,21.4,39,23,26,12,1,24,32,75.0,8,30,18,12,35,74,73,2
Napoli,Leonardo Spinazzola,it ITA,DF,31.0,17.0,17,10,6,9,2,10,23,43.5,13,12,1,11,9,26,31,1
Napoli,Khvicha Kvaratskhelia,ge GEO,FW,23.0,13.2,15,9,4,10,1,4,15,26.7,11,13,0,13,4,19,7,0
Napoli,David Neres,br BRA,FW,27.0,14.4,21,11,10,4,7,10,15,66.7,5,7,0,7,7,28,4,0
Napoli,Billy Gilmour,sct SCO,MF,23.0,13.2,24,16,10,9,5,12,20,60.0,8,6,1,5,9,33,23,0
Napoli,Juan Jesus,br BRA,DF,33.0,12.0,25,14,16,9,0,12,20,60.0,8,15,3,12,9,34,42,0
Napoli,Giacomo Raspadori,it ITA,FW,24.0,12.4,18,9,6,10,2,8,12,66.7,4,10,2,8,3,21,13,0
Napoli,Pasquale Mazzocchi,it ITA,DF,29.0,7.8,15,7,7,5,3,8,15,53.3,7,5,2,3,5,20,25,0
Napoli,Elia Caprile,it ITA,GK,22.0,3.6,0,0,0,0,0,0,0,,0,0,0,0,0,0,2,0
Napoli,Giovanni Simeone,ar ARG,FW,29.0,4.7,2,0,0,1,1,1,6,16.7,5,9,2,7,1,3,6,0
Napoli,Cyril Ngonge,be BEL,FW,24.0,2.4,8,5,4,4,0,4,7,57.1,3,3,0,3,2,10,4,0
Napoli,Philip Billing,dk DEN,MF,28.0,2.2,9,6,4,4,1,1,4,25.0,3,4,1,3,4,13,6,0
Napoli,Rafa Marín,es ESP,DF,22.0,1.6,1,0,1,0,0,1,2,50.0,1,1,1,0,1,2,4,0
Napoli,Simone Scuffet,it ITA,GK,28.0,1.0,0,0,0,0,0,0,0,,0,0,0,0,0,0,2,0
Napoli,Noah Okafor,ch SUI,FW,24.0,0.4,3,2,3,0,0,2,2,100.0,0,0,0,0,0,3,1,0
Napoli,Michael Folorunsho,it ITA,FW,26.0,0.4,3,2,0,3,0,2,4,50.0,2,0,0,0,1,4,1,1
Napoli,Walid Cheddira,ma MAR,FW,26.0,0.1,0,0,0,0,0,0,0,,0,0,0,0,0,0,0,0
Napoli,Alessio Zerbin,it ITA,"FW,DF",25.0,0.0,2,1,2,0,0,1,1,100.0,0,0,0,0,0,2,0,0
Internazionale,Yann Sommer,ch SUI,GK,35.0,33.0,0,0,0,0,0,0,0,,0,0,0,0,0,0,13,1
Internazionale,Lautaro Martínez,ar ARG,FW,26.0,28.7,30,16,10,12,8,13,25,52.0,12,21,3,18,10,40,15,0
Internazionale,Alessandro Bastoni,it ITA,DF,25.0,26.9,46,24,26,14,6,20,30,66.7,10,25,13,12,22,68,52,1
Internazionale,Henrikh Mkhitaryan,am ARM,MF,35.0,26.8,43,24,17,16,10,20,45,44.4,25,29,5,24,17,60,41,0
Internazionale,Nicolò Barella,it ITA,MF,27.0,27.8,50,31,19,20,11,26,59,44.1,33,26,3,23,12,62,16,1
Internazionale,Federico Dimarco,it ITA,DF,26.0,24.4,25,14,10,12,3,10,19,52.6,9,24,4,20,14,39,33,2
Internazionale,Marcus Thuram,fr FRA,FW,26.0,25.6,18,10,7,5,6,3,14,21.4,11,16,3,13,3,21,15,0
Internazionale,Hakan Çalhanoğlu,tr TUR,MF,30.0,21.8,43,23,7,23,13,21,36,58.3,15,17,8,9,18,61,24,0
Internazionale,Denzel Dumfries,nl NED,DF,28.0,21.8,25,18,12,9,4,14,27,51.9,13,31,8,23,6,31,26,1
Internazionale,Matteo Darmian,it ITA,DF,34.0,19.9,28,17,12,12,4,14,25,56.0,11,14,6,8,10,38,39,0
Internazionale,Francesco Acerbi,it ITA,DF,36.0,19.0,23,19,16,7,0,11,17,64.7,6,22,16,6,26,49,81,0
Internazionale,Stefan de Vrij,nl NED,DF,32.0,19.2,18,12,12,5,1,9,12,75.0,3,19,11,8,23,41,89,0
Internazionale,Benjamin Pavard,fr FRA,DF,28.0,17.6,29,16,12,12,5,18,25,72.0,7,16,12,4,16,45,52,0
Internazionale,Yann Aurel Bisseck,de GER,DF,23.0,18.3,17,12,11,4,2,11,16,68.8,5,23,12,11,17,34,64,1
Internazionale,Carlos Augusto,br BRA,DF,25.0,18.8,29,14,12,11,6,12,19,63.2,7,21,9,12,9,38,50,0
Internazionale,Kristjan Asllani,al ALB,MF,22.0,11.0,14,3,8,4,2,8,22,36.4,14,8,1,7,9,23,13,1
Internazionale,Davide Frattesi,it ITA,MF,24.0,13.7,17,8,6,10,1,10,18,55.6,8,12,4,8,5,22,14,1
Internazionale,Piotr Zieliński,pl POL,MF,30.0,10.9,14,10,6,7,1,6,13,46.2,7,10,5,5,6,20,13,1
Internazionale,Mehdi Taremi,ir IRN,FW,32.0,9.1,7,1,2,2,3,1,4,25.0,3,11,2,9,0,7,11,0
Internazionale,Joaquín Correa,ar ARG,FW,29.0,8.1,11,5,4,7,0,4,13,30.8,9,3,0,3,0,11,6,0
Internazionale,Marko Arnautović,at AUT,FW,35.0,6.1,7,6,1,3,3,3,5,60.0,2,3,0,3,1,8,1,0
Internazionale,Josep Martinez,es ESP,GK,26.0,5.0,0,0,0,0,0,0,0,,0,0,0,0,0,0,0,0
Internazionale,Nicola Zalewski,pl POL,DF,22.0,4.9,7,4,3,2,2,4,6,66.7,2,5,1,4,2,9,5,1
Internazionale,Tajon Buchanan,ca CAN,DF,25.0,1.1,3,0,2,0,1,1,2,50.0,1,0,0,0,0,3,3,0
Internazionale,Tomás Palacios,ar ARG,DF,21.0,0.1,0,0,0,0,0,0,0,,0,0,0,0,1,1,0,0
Internazionale,Luka Topalović,si SVN,MF,18.0,0.1,1,1,0,1,0,0,0,,0,0,0,0,0,1,0,0
Atalanta,Marco Carnesecchi,it ITA,GK,24.0,34.0,0,0,0,0,0,0,0,,0,1,0,1,0,0,26,2
Atalanta,Marten de Roon,nl NED,MF,33.0,34.0,74,48,32,38,4,30,66,45.5,36,40,7,33,47,121,67,1
Atalanta,Éderson,br BRA,MF,25.0,32.1,52,32,19,28,5,22,34,64.7,12,30,6,24,35,87,36,1
Atalanta,Berat Djimsiti,al ALB,DF,31.0,29.4,53,33,29,23,1,29,40,72.5,11,34,21,13,40,93,141,2
Atalanta,Mateo Retegui,it ITA,FW,25.0,26.8,14,9,0,9,5,3,16,18.8,13,7,0,7,4,18,17,0
Atalanta,Ademola Lookman,ng NGA,MF,26.0,25.2,32,15,9,15,8,11,19,57.9,8,19,0,19,3,35,5,1
Atalanta,Raoul Bellanova,it ITA,DF,24.0,26.8,24,14,8,13,3,13,21,61.9,8,12,3,9,18,42,45,0
Atalanta,Isak Hien,se SWE,DF,25.0,25.9,48,28,27,21,0,27,44,61.4,17,31,18,13,31,79,82,2
Atalanta,Davide Zappacosta,it ITA,DF,32.0,23.1,26,16,15,5,6,20,39,51.3,19,28,6,22,11,37,32,2
Atalanta,Charles De Ketelaere,be BEL,MF,23.0,23.2,13,9,2,9,2,4,15,26.7,11,14,3,11,3,16,9,1
Atalanta,Mario Pašalić,hr CRO,MF,29.0,22.0,26,16,11,13,2,11,26,42.3,15,22,7,15,12,38,28,1
Atalanta,Sead Kolašinac,ba BIH,DF,31.0,21.2,41,26,21,20,0,16,30,53.3,14,16,7,9,25,66,53,1
Atalanta,Matteo Ruggeri,it ITA,DF,22.0,19.5,39,24,15,14,10,25,39,64.1,14,30,4,26,22,61,50,1
Atalanta,Odilon Kossounou,ci CIV,DF,23.0,12.5,16,11,8,6,2,6,13,46.2,7,16,6,10,13,29,25,1
Atalanta,Marco Brescianini,it ITA,MF,24.0,11.1,18,11,5,9,4,8,10,80.0,2,15,2,13,2,20,6,0
Atalanta,Lazar Samardzic,rs SRB,MF,22.0,13.0,21,15,5,7,9,12,25,48.0,13,9,1,8,2,23,6,0
Atalanta,Juan Cuadrado,co COL,DF,36.0,9.3,19,9,9,6,4,11,23,47.8,12,14,2,12,7,26,9,0
Atalanta,Stefan Posch,at AUT,DF,27.0,4.3,18,11,7,8,3,8,9,88.9,1,5,1,4,4,22,13,0
Atalanta,Giorgio Scalvini,it ITA,DF,20.0,3.1,8,4,5,3,0,5,9,55.6,4,0,0,0,4,12,7,0
Atalanta,Ibrahim Sulemana,gh GHA,MF,21.0,3.2,9,4,4,5,0,2,8,25.0,6,2,0,2,0,9,1,0
Atalanta,Rui Patrício,pt POR,GK,36.0,3.0,0,0,0,0,0,0,0,,0,0,0,0,0,0,3,0
Atalanta,Rafael Tolói,it ITA,DF,33.0,5.2,10,5,3,5,2,4,11,36.4,7,8,2,6,8,18,11,0
Atalanta,Daniel Maldini,it ITA,FW,22.0,2.9,2,2,0,1,1,1,2,50.0,1,1,0,1,2,4,3,0
Atalanta,Marco Palestra,it ITA,DF,19.0,2.5,6,4,3,2,1,3,3,100.0,0,4,1,3,2,8,4,0
Atalanta,Juan Musso,ar ARG,GK,30.0,1.0,0,0,0,0,0,0,0,,0,0,0,0,0,0,0,0
Atalanta,Nicolò Zaniolo,it ITA,FW,25.0,4.0,0,0,0,0,0,0,2,0.0,2,0,0,0,1,1,0,0
Atalanta,Vanja Vlahović,rs SRB,FW,20.0,0.7,1,1,0,0,1,0,0,,0,0,0,0,0,1,0,0
Atalanta,Ben Godfrey,eng ENG,DF,26.0,0.3,0,0,0,0,0,0,1,0.0,1,1,1,0,0,0,0,0
Atalanta,Mitchel Bakker,nl NED,MF,24.0,0.2,1,0,1,0,0,1,1,100.0,0,0,0,0,0,1,0,0
Atalanta,Federico Cassa,it ITA,MF,18.0,0.2,0,0,0,0,0,0,0,,0,1,0,1,0,0,0,0
Atalanta,Alberto Manzoni,it ITA,MF,19.0,0.1,0,0,0,0,0,0,0,,0,0,0,0,0,0,0,0
Atalanta,Gianluca Scamacca,it ITA,FW,25.0,0.1,0,0,0,0,0,0,0,,0,0,0,0,0,0,0,0
Juventus,Manuel Locatelli,it ITA,MF,26.0,31.5,72,49,29,35,8,32,56,57.1,24,58,20,38,23,95,77,0
Juventus,Michele Di Gregorio,it ITA,GK,27.0,33.0,0,0,0,0,0,0,0,,0,0,0,0,1,1,14,0
Juventus,Kenan Yıldız,tr TUR,FW,19.0,26.8,54,30,13,26,15,18,32,56.3,14,25,0,25,5,59,13,3
Juventus,Weston McKennie,us USA,MF,25.0,25.8,33,12,18,11,4,13,22,59.1,9,28,8,20,14,47,37,0
Juventus,Khéphren Thuram,fr FRA,MF,23.0,26.0,44,21,16,24,4,18,32,56.3,14,32,10,22,14,58,39,2
Juventus,Federico Gatti,it ITA,DF,26.0,24.5,28,23,18,8,2,14,24,58.3,10,27,18,9,18,46,76,2
Juventus,Pierre Kalulu,fr FRA,DF,24.0,26.0,41,25,29,9,3,18,24,75.0,6,27,15,12,17,58,68,1
Juventus,Andrea Cambiaso,it ITA,DF,24.0,24.8,46,30,27,13,6,27,44,61.4,17,24,4,20,16,62,34,5
Juventus,Teun Koopmeiners,nl NED,MF,26.0,22.2,32,16,6,19,7,10,30,33.3,20,36,14,22,8,40,26,2
Juventus,Nicolás González,ar ARG,FW,26.0,19.6,24,13,10,9,5,9,25,36.0,16,16,4,12,9,33,37,2
Juventus,Dušan Vlahović,rs SRB,FW,24.0,19.9,4,2,0,1,3,1,5,20.0,4,7,3,4,1,5,9,3
Juventus,Nicolò Savona,it ITA,DF,21.0,19.3,29,13,19,9,1,13,25,52.0,12,12,3,9,11,40,38,0
Juventus,Timothy Weah,us USA,DF,24.0,18.3,36,19,15,13,8,14,25,56.0,11,25,4,21,14,50,27,2
Juventus,Randal Kolo Muani,fr FRA,FW,25.0,13.0,11,7,3,5,3,4,5,80.0,1,8,0,8,4,15,2,0
Juventus,Francisco Conceição,pt POR,FW,21.0,15.0,23,14,6,9,8,13,30,43.3,17,7,0,7,6,29,6,0
Juventus,Renato Veiga,pt POR,DF,21.0,12.2,17,12,7,9,1,9,14,64.3,5,17,13,4,19,36,81,0
Juventus,Lloyd Kelly,eng ENG,DF,25.0,11.3,15,11,5,9,1,7,9,77.8,2,11,6,5,2,17,56,3
Juventus,Samuel Mbangula,be BEL,FW,20.0,7.9,15,10,7,6,2,7,13,53.8,6,7,0,7,3,18,4,0
Juventus,Danilo,br BRA,DF,33.0,6.5,10,4,7,2,1,5,10,50.0,5,4,3,1,9,19,21,1
Juventus,Gleison Bremer,br BRA,DF,27.0,6.0,15,7,9,5,1,4,5,80.0,1,15,11,4,6,21,16,0
Juventus,Juan David Cabal,co COL,DF,23.0,5.1,10,4,7,3,0,8,12,66.7,4,2,0,2,2,12,14,1
Juventus,Nicolò Fagioli,it ITA,MF,23.0,6.4,14,10,7,6,1,6,9,66.7,3,4,0,4,2,16,5,0
Juventus,Mattia Perin,it ITA,GK,31.0,5.0,0,0,0,0,0,0,0,,0,0,0,0,0,0,2,0
Juventus,Douglas Luiz,br BRA,MF,26.0,5.9,13,8,7,5,1,6,9,66.7,3,5,2,3,4,17,5,0
Juventus,Alberto costa,pt POR,DF,20.0,4.0,14,10,7,5,2,7,9,77.8,2,5,1,4,4,18,14,0
Juventus,Jonas Rouhi,se SWE,DF,20.0,2.3,4,1,1,3,0,0,1,0.0,1,2,0,2,3,7,2,0
Juventus,Vasilije Adžić,me MNE,MF,18.0,0.5,2,2,0,1,1,0,1,0.0,1,0,0,0,0,2,0,0
Juventus,Diego Pugno,it ITA,FW,18.0,0.1,0,0,0,0,0,0,0,,0,0,0,0,0,0,0,0
Juventus,Lorenzo Anghelè,it ITA,FW,19.0,0.1,0,0,0,0,0,0,0,,0,0,0,0,0,0,0,0
Roma,Obite N'Dicka,ci CIV,DF,24.0,38.0,32,26,17,15,0,14,21,66.7,7,46,30,16,33,65,150,2
Roma,Mile Svilar,rs SRB,GK,24.0,38.0,0,0,0,0,0,0,0,,0,0,0,0,0,0,12,2
Roma,Angeliño,es ESP,DF,27.0,35.3,46,24,20,24,2,17,34,50.0,17,33,9,24,28,74,98,0
Roma,Gianluca Mancini,it ITA,DF,28.0,34.9,42,26,22,18,2,20,34,58.8,14,22,16,6,35,77,103,0
Roma,Manu Koné,fr FRA,MF,23.0,28.7,41,26,17,17,7,19,40,47.5,21,27,4,23,24,65,28,0
Roma,Artem Dovbyk,ua UKR,FW,27.0,27.1,4,2,0,1,3,0,4,0.0,4,10,3,7,2,6,12,0
Roma,Zeki Çelik,tr TUR,DF,27.0,25.2,62,37,21,31,10,23,43,53.5,20,28,9,19,15,77,84,3
Roma,Bryan Cristante,it ITA,MF,29.0,22.8,48,29,18,24,6,15,26,57.7,11,20,10,10,19,67,36,1
Roma,Matìas Soulé,ar ARG,MF,21.0,20.0,26,16,12,7,7,10,23,43.5,13,25,3,22,9,35,25,0
Roma,Lorenzo Pellegrini,it ITA,MF,28.0,18.2,24,16,5,13,6,8,19,42.1,11,8,1,7,6,30,22,0
Roma,Alexis Saelemaekers,be BEL,DF,25.0,15.6,33,20,22,7,4,18,35,51.4,17,12,1,11,9,42,8,1
Roma,Paulo Dybala,ar ARG,FW,30.0,15.9,17,7,3,9,5,8,19,42.1,11,12,1,11,2,19,2,0
Roma,Leandro Paredes,ar ARG,MF,30.0,15.3,26,14,9,12,5,16,32,50.0,16,14,5,9,19,45,33,2
Roma,Stephan El Shaarawy,it ITA,DF,31.0,12.3,16,12,4,6,6,6,12,50.0,6,4,0,4,10,26,13,0
Roma,Niccolò Pisilli,it ITA,MF,19.0,13.7,24,11,11,8,5,12,22,54.5,10,14,3,11,11,35,16,0
Roma,Eldor Shomurodov,uz UZB,FW,29.0,12.3,14,6,2,7,5,3,6,50.0,3,10,1,9,3,17,5,0
Roma,Mats Hummels,de GER,DF,35.0,10.2,30,15,16,14,0,11,18,61.1,7,12,4,8,26,56,43,0
Roma,Tommaso Baldanzi,it ITA,MF,21.0,9.3,12,4,5,4,3,4,12,33.3,8,4,0,4,6,18,8,0
Roma,Devyne Rensch,nl NED,DF,21.0,5.2,17,13,8,8,1,9,10,90.0,1,5,3,2,7,24,12,1
Roma,Nicola Zalewski,pl POL,DF,22.0,6.0,8,6,3,2,3,2,7,28.6,5,7,2,5,4,12,8,2
Roma,Enzo Le Fée,fr FRA,MF,24.0,3.6,7,4,5,2,0,2,6,33.3,4,9,3,6,5,12,2,0
Roma,Mario Hermoso,es ESP,DF,29.0,2.8,2,1,2,0,0,0,1,0.0,1,1,1,0,4,6,13,0
Roma,Lucas Gourna-Douath,fr FRA,MF,20.0,2.6,9,4,5,4,0,2,6,33.3,4,1,1,0,0,9,2,0
Roma,Saud Abdulhamid,sa KSA,DF,25.0,2.3,3,2,2,0,1,1,1,100.0,0,2,0,2,2,5,0,0
Roma,Anass Salah-Eddine,nl NED,DF,22.0,1.7,1,1,1,0,0,0,0,,0,0,0,0,1,2,2,2
Roma,Victor Nelsson,dk DEN,DF,25.0,2.1,5,4,3,1,1,3,5,60.0,2,1,0,1,2,7,9,0
Roma,Samuel Dahl,se SWE,DF,24.0,0.5,2,2,0,2,0,1,2,50.0,1,2,0,2,0,2,0,0
Roma,Tammy Abraham,eng ENG,FW,26.0,0.0,0,0,0,0,0,0,1,0.0,1,0,0,0,0,0,0,0
Fiorentina,David de Gea,es ESP,GK,33.0,35.0,1,0,1,0,0,1,1,100.0,0,0,0,0,0,1,12,0
Fiorentina,Dodô,br BRA,DF,25.0,34.7,44,30,25,11,8,25,49,51.0,24,22,5,17,35,79,58,2
Fiorentina,Luca Ranieri,it ITA,DF,25.0,34.2,42,24,28,12,2,20,25,80.0,5,47,32,15,28,70,154,1
Fiorentina,Moise Kean,it ITA,FW,24.0,30.1,7,5,1,2,4,3,4,75.0,1,12,0,12,6,13,26,1
Fiorentina,Robin Gosens,de GER,DF,30.0,28.1,56,32,31,17,8,25,44,56.8,19,34,11,23,18,74,91,0
Fiorentina,Pietro Comuzzo,it ITA,DF,19.0,24.5,43,21,29,11,3,23,29,79.3,6,35,22,13,29,72,113,4
Fiorentina,Danilo Cataldi,it ITA,MF,29.0,19.4,25,16,13,10,2,14,27,51.9,13,17,8,9,22,47,35,0
Fiorentina,Rolando Mandragora,it ITA,MF,27.0,21.6,23,13,9,12,2,14,31,45.2,17,22,7,15,17,40,54,1
Fiorentina,Lucas Beltrán,ar ARG,FW,23.0,21.9,23,10,10,7,6,7,21,33.3,14,15,2,13,5,28,14,0
Fiorentina,Andrea Colpani,it ITA,FW,25.0,16.3,15,9,5,7,3,4,12,33.3,8,7,0,7,9,24,10,0
Fiorentina,Albert Guðmundsson,is ISL,FW,27.0,14.3,9,5,2,4,3,7,17,41.2,10,5,0,5,6,15,9,1
Fiorentina,Yacine Adli,fr FRA,MF,24.0,13.5,32,19,11,16,5,17,39,43.6,22,13,1,12,6,38,19,0
Fiorentina,Marin Pongračić,hr CRO,DF,26.0,15.2,18,13,13,4,1,7,11,63.6,4,14,6,8,12,30,69,2
Fiorentina,Pablo Marí,es ESP,DF,30.0,12.2,14,9,11,3,0,6,11,54.5,5,19,14,5,25,39,94,0
Fiorentina,Fabiano Parisi,it ITA,DF,23.0,12.6,27,17,11,12,4,12,21,57.1,9,14,2,12,17,44,17,0
Fiorentina,Edoardo Bove,it ITA,MF,22.0,9.5,24,17,7,14,3,14,28,50.0,14,12,0,12,6,30,8,0
Fiorentina,Amir Richardson,ma MAR,MF,22.0,12.3,30,13,13,15,2,9,21,42.9,12,14,1,13,6,36,29,1
Fiorentina,Nicolò Fagioli,it ITA,MF,23.0,10.7,19,10,8,9,2,9,22,40.9,13,11,2,9,5,24,12,2
Fiorentina,Riccardo Sottil,it ITA,FW,25.0,9.3,5,4,3,1,1,3,4,75.0,1,1,0,1,4,9,3,0
Fiorentina,Michael Folorunsho,it ITA,FW,26.0,7.3,19,12,9,6,4,8,20,40.0,12,9,1,8,4,23,10,0
Fiorentina,Christian Kouamé,ci CIV,FW,26.0,7.0,13,8,4,4,5,0,3,0.0,3,3,1,2,2,15,10,0
Fiorentina,Cristiano Biraghi,it ITA,DF,31.0,4.8,4,4,1,3,0,2,7,28.6,5,2,0,2,4,8,11,0
Fiorentina,Cher Ndour,it ITA,MF,20.0,4.5,4,1,2,1,1,2,10,20.0,8,5,1,4,2,6,7,1
Fiorentina,Lucas Martínez Quarta,ar ARG,DF,28.0,3.9,12,7,9,3,0,8,13,61.5,5,5,2,3,3,15,25,1
Fiorentina,Nicolò Zaniolo,it ITA,FW,25.0,3.8,3,1,1,2,0,0,4,0.0,4,2,1,1,0,3,2,0
Fiorentina,Pietro Terracciano,it ITA,GK,34.0,3.0,0,0,0,0,0,0,0,,0,0,0,0,0,0,0,0
Fiorentina,Sofyan Amrabat,ma MAR,MF,27.0,2.0,3,2,1,2,0,2,2,100.0,0,1,1,0,0,3,2,0
Fiorentina,Matias Moreno,ar ARG,DF,20.0,1.6,8,8,5,3,0,4,4,100.0,0,5,1,4,1,9,9,0
Fiorentina,Jonathan Ikone,fr FRA,FW,26.0,3.7,5,2,3,2,0,2,4,50.0,2,3,0,3,1,6,1,0
Fiorentina,Michael Kayode,it ITA,DF,20.0,1.4,1,1,1,0,0,0,0,,0,3,1,2,2,3,7,0
Fiorentina,Antonín Barák,cz CZE,MF,29.0,0.6,2,0,0,2,0,0,2,0.0,2,1,1,0,0,2,0,0
Fiorentina,Alessandro Bianco,it ITA,MF,21.0,0.2,0,0,0,0,0,0,1,0.0,1,0,0,0,0,0,0,0
Fiorentina,Maat Daniel Caprini,it ITA,FW,18.0,0.1,0,0,0,0,0,0,0,,0,0,0,0,0,0,0,0
Fiorentina,Tommaso Rubino,it ITA,MF,17.0,0.1,0,0,0,0,0,0,1,0.0,1,0,0,0,0,0,0,0
Lazio,Mattéo Guendouzi,fr FRA,MF,25.0,36.4,37,21,13,19,5,20,47,42.6,27,34,9,25,32,69,50,2
Lazio,Mattia Zaccagni,it ITA,FW,29.0,30.1,38,27,13,21,4,16,32,50.0,16,19,1,18,29,67,22,2
Lazio,Mario Gila,es ESP,DF,23.0,30.5,55,37,35,18,2,37,56,66.1,19,20,13,7,28,83,115,4
Lazio,Nicolò Rovella,it ITA,MF,22.0,30.3,84,50,39,38,7,41,79,51.9,38,19,4,15,47,131,46,3
Lazio,Alessio Romagnoli,it ITA,DF,29.0,29.7,48,29,20,26,2,22,27,81.5,5,33,17,16,26,74,118,1
Lazio,Ivan Provedel,it ITA,GK,30.0,29.0,0,0,0,0,0,0,0,,0,1,0,1,1,1,12,3
Lazio,Gustav Isaksen,dk DEN,FW,23.0,24.8,16,9,7,8,1,7,28,25.0,21,22,2,20,10,26,21,1
Lazio,Valentín Castellanos,ar ARG,FW,25.0,26.6,13,6,2,4,7,1,10,10.0,9,18,2,16,6,19,25,0
Lazio,Boulaye Dia,sn SEN,MF,27.0,24.4,22,10,5,12,5,7,16,43.8,9,12,1,11,6,28,16,1
Lazio,Adam Marušić,me MNE,DF,31.0,26.0,32,20,18,12,2,18,30,60.0,12,18,8,10,16,48,61,0
Lazio,Nuno Tavares,pt POR,DF,24.0,18.9,28,21,15,8,5,14,34,41.2,20,21,3,18,21,49,44,2
Lazio,Manuel Lazzari,it ITA,DF,30.0,15.7,26,16,13,11,2,14,24,58.3,10,9,5,4,10,36,19,0
Lazio,Fisayo Dele-Bashiru,ng NGA,MF,23.0,10.6,10,6,3,3,4,2,6,33.3,4,10,2,8,4,14,5,0
Lazio,Luca Pellegrini,it ITA,DF,25.0,11.9,23,11,11,10,2,17,32,53.1,15,10,3,7,19,42,32,0
Lazio,Christos Mandas,gr GRE,GK,22.0,9.0,0,0,0,0,0,0,0,,0,0,0,0,0,0,4,0
Lazio,Tijjani Noslin,nl NED,FW,25.0,9.6,6,5,2,1,3,1,8,12.5,7,15,1,14,1,7,7,0
Lazio,Matías Vecino,uy URU,MF,32.0,9.8,13,7,3,9,1,4,18,22.2,14,9,3,6,5,18,15,0
Lazio,Samuel Gigot,fr FRA,DF,30.0,7.6,4,3,1,3,0,0,1,0.0,1,8,6,2,13,17,36,0
Lazio,Pedro,es ESP,FW,37.0,12.3,19,14,5,9,5,10,21,47.6,11,11,0,11,3,22,3,1
Lazio,Loum Tchaouna,fr FRA,FW,20.0,7.4,8,4,2,2,4,3,9,33.3,6,5,1,4,4,12,14,2
Lazio,Patric,es ESP,DF,31.0,6.8,9,6,6,3,0,6,10,60.0,4,3,2,1,3,12,22,1
Lazio,Elseid Hysaj,al ALB,DF,30.0,4.7,11,6,6,5,0,3,3,100.0,0,5,2,3,5,16,21,0
Lazio,Nicolò Casale,it ITA,DF,26.0,1.5,5,3,4,1,0,0,0,,0,4,3,1,1,6,2,0
Lazio,Reda Belahyane,ma MAR,MF,20.0,2.2,8,6,8,0,0,6,6,100.0,0,3,2,1,1,9,5,0
Lazio,Gaetano Castrovilli,it ITA,MF,27.0,1.7,5,2,3,1,1,2,4,50.0,2,3,0,3,3,8,1,0
Lazio,Oliver Nielsen,dk DEN,DF,21.0,0.4,0,0,0,0,0,0,0,,0,1,0,1,1,1,2,0
Lazio,Arijon Ibrahimović,de GER,MF,18.0,0.1,0,0,0,0,0,0,0,,0,0,0,0,0,0,0,0
Milan,Mike Maignan,fr FRA,GK,29.0,36.6,0,0,0,0,0,0,1,0.0,1,1,0,1,0,0,19,3
Milan,Tijjani Reijnders,nl NED,MF,26.0,34.8,26,13,6,14,6,10,26,38.5,16,22,4,18,38,64,28,2
Milan,Theo Hernández,fr FRA,DF,26.0,30.0,36,28,23,10,3,21,39,53.8,18,25,10,15,17,53,75,3
Milan,Youssouf Fofana,fr FRA,MF,25.0,27.9,56,34,20,31,5,26,52,50.0,26,32,9,23,19,75,24,3
Milan,Christian Pulisic,us USA,FW,25.0,27.7,43,29,17,14,12,15,37,40.5,22,24,2,22,5,48,13,2
Milan,Rafael Leão,pt POR,FW,25.0,25.9,16,10,4,8,4,11,29,37.9,18,15,1,14,6,22,4,0
Milan,Matteo Gabbia,it ITA,DF,24.0,24.0,21,15,13,7,1,8,10,80.0,2,25,19,6,15,36,103,1
Milan,Strahinja Pavlović,rs SRB,DF,23.0,20.7,52,31,32,19,1,29,50,58.0,21,17,6,11,16,68,82,0
Milan,Malick Thiaw,de GER,DF,22.0,20.1,24,17,15,6,3,6,10,60.0,4,14,12,2,15,39,76,1
Milan,Fikayo Tomori,eng ENG,DF,26.0,17.7,40,25,21,16,3,17,25,68.0,8,17,12,5,20,60,61,2
Milan,Yunus Musah,us USA,MF,21.0,17.6,27,19,13,9,5,12,17,70.6,5,9,1,8,7,34,9,3
Milan,Emerson,br BRA,DF,25.0,15.4,45,28,24,16,5,16,34,47.1,18,13,2,11,14,59,56,0
Milan,Alejandro Jiménez,es ESP,DF,19.0,14.2,24,13,8,14,2,11,27,40.7,16,24,3,21,15,39,23,0
Milan,Álvaro Morata,es ESP,FW,31.0,12.3,16,10,5,8,3,5,8,62.5,3,7,2,5,5,21,5,0
Milan,Tammy Abraham,eng ENG,FW,26.0,13.2,17,11,2,10,5,6,8,75.0,2,13,0,13,2,19,16,0
Milan,Ruben Loftus-Cheek,eng ENG,MF,28.0,11.6,19,8,6,9,4,6,12,50.0,6,3,0,3,3,22,20,0
Milan,Samuel Chukwueze,ng NGA,FW,25.0,10.4,17,11,7,6,4,5,19,26.3,14,3,0,3,2,19,9,0
Milan,João Félix,pt POR,MF,24.0,8.5,6,6,3,2,1,4,14,28.6,10,2,0,2,1,7,9,0
Milan,Santiago Giménez,mx MEX,FW,23.0,7.5,5,3,0,4,1,3,4,75.0,1,3,1,2,1,6,13,0
Milan,Kyle Walker,eng ENG,DF,34.0,7.3,17,9,12,4,1,13,17,76.5,4,9,5,4,9,26,15,1
Milan,Luka Jović,rs SRB,FW,26.0,6.2,0,0,0,0,0,0,0,,0,2,1,1,1,1,3,0
Milan,Filippo Terracciano,it ITA,DF,21.0,6.0,9,6,1,6,2,5,10,50.0,5,1,0,1,6,15,11,0
Milan,Noah Okafor,ch SUI,FW,24.0,4.6,2,1,0,0,2,0,1,0.0,1,1,0,1,2,4,1,0
Milan,Davide Calabria,it ITA,DF,27.0,3.6,10,7,10,0,0,4,7,57.1,3,1,0,1,8,18,8,0
Milan,Ismaël Bennacer,dz ALG,MF,26.0,3.4,5,4,1,3,1,1,7,14.3,6,5,3,2,3,8,1,0
Milan,Warren Bondo,fr FRA,MF,20.0,1.8,5,3,4,1,0,3,3,100.0,0,1,0,1,0,5,2,0
Milan,Francesco Camarda,it ITA,FW,16.0,2.3,5,2,0,2,3,2,6,33.3,4,2,1,1,0,5,3,0
Milan,Marco Sportiello,it ITA,GK,32.0,1.4,0,0,0,0,0,0,0,,0,0,0,0,0,0,1,0
Milan,Riccardo Sottil,it ITA,FW,25.0,1.4,1,1,1,0,0,0,0,,0,0,0,0,0,1,0,0
Milan,Davide Bartesaghi,it ITA,DF,18.0,1.3,4,2,1,1,2,4,4,100.0,0,1,1,0,3,7,1,0
Milan,Alexis Saelemaekers,be BEL,DF,25.0,1.0,1,1,0,0,1,1,1,100.0,0,0,0,0,1,2,0,0
Milan,Mattia Liberali,it ITA,MF,17.0,0.7,2,1,0,1,1,2,2,100.0,0,0,0,0,0,2,0,0
Milan,Kevin Zeroli,it ITA,MF,19.0,0.1,1,1,0,1,0,0,0,,0,0,0,0,0,1,0,0
Milan,Alessandro Florenzi,it ITA,FW,33.0,0.1,0,0,0,0,0,0,0,,0,0,0,0,0,0,0,0
Milan,Bob Murphy Omoregbe,it ITA,MF,20.0,0.0,0,0,0,0,0,0,0,,0,0,0,0,0,0,0,0
Bologna,Remo Freuler,ch SUI,MF,32.0,35.7,79,40,28,40,11,33,79,41.8,46,38,4,34,38,117,57,1
Bologna,Sam Beukema,nl NED,DF,25.0,33.5,54,29,27,24,3,22,41,53.7,19,36,21,15,30,84,111,0
Bologna,Jhon Lucumí,co COL,DF,26.0,29.1,53,30,23,29,1,29,41,70.7,12,32,14,18,26,79,88,7
Bologna,Łukasz Skorupski,pl POL,GK,33.0,26.3,1,0,1,0,0,1,3,33.3,2,0,0,0,0,1,13,2
Bologna,Santiago Castro,ar ARG,FW,19.0,25.7,18,10,4,9,5,6,17,35.3,11,13,2,11,3,21,20,0
Bologna,Dan Ndoye,ch SUI,FW,23.0,23.9,26,19,8,8,10,16,28,57.1,12,23,0,23,9,35,4,0
Bologna,Juan Miranda,es ESP,DF,24.0,25.3,32,18,11,14,7,14,33,42.4,19,21,3,18,23,55,50,1
Bologna,Jens Odgaard,dk DEN,MF,25.0,21.9,20,14,3,12,5,6,21,28.6,15,19,2,17,9,29,12,1
Bologna,Riccardo Orsolini,it ITA,FW,27.0,21.0,16,13,6,6,4,5,11,45.5,6,26,0,26,8,24,10,1
Bologna,Benjamín Domínguez,ar ARG,FW,20.0,14.4,18,7,2,11,5,6,20,30.0,14,15,1,14,4,22,7,0
Bologna,Nikola Moro,hr CRO,MF,26.0,13.5,35,27,7,21,7,22,33,66.7,11,18,7,11,13,48,18,0
Bologna,Tommaso Pobega,it ITA,MF,25.0,13.1,33,19,12,15,6,22,30,73.3,8,16,4,12,14,47,16,0
Bologna,Lorenzo De Silvestri,it ITA,DF,36.0,11.9,11,6,7,1,3,7,16,43.8,9,12,4,8,10,21,32,0
Bologna,Emil Holm,se SWE,DF,24.0,12.7,34,21,17,14,3,20,31,64.5,11,19,4,15,10,44,51,1
Bologna,Charalambos Lykogiannis,gr GRE,DF,30.0,11.7,23,14,14,8,1,10,20,50.0,10,10,5,5,11,34,41,1
Bologna,Thijs Dallinga,nl NED,FW,23.0,12.9,10,5,0,4,6,3,3,100.0,0,10,1,9,1,11,13,1
Bologna,Federico Ravaglia,it ITA,GK,24.0,11.7,0,0,0,0,0,0,0,,0,0,0,0,0,0,9,0
Bologna,Lewis Ferguson,sct SCO,MF,24.0,10.9,24,13,4,14,6,9,16,56.3,7,9,2,7,5,29,9,0
Bologna,Giovanni Fabbian,it ITA,MF,21.0,11.4,10,6,1,3,6,7,13,53.8,6,7,2,5,2,12,4,0
Bologna,Nicolò Casale,it ITA,DF,26.0,10.0,11,5,4,6,1,5,10,50.0,5,15,7,8,17,28,43,3
Bologna,Michel Aebischer,ch SUI,MF,27.0,8.1,18,13,8,7,3,10,14,71.4,4,4,1,3,7,25,6,0
Bologna,Stefan Posch,at AUT,DF,27.0,7.9,26,15,12,9,5,15,25,60.0,10,19,4,15,5,31,22,0
Bologna,Davide Calabria,it ITA,DF,27.0,7.0,12,8,5,5,2,5,12,41.7,7,4,0,4,3,15,22,1
Bologna,Martin Erlic,hr CRO,DF,26.0,3.7,2,0,0,2,0,1,2,50.0,1,5,4,1,2,4,9,0
Bologna,Nicolò Cambiaghi,it ITA,FW,23.0,6.9,16,10,6,7,3,5,10,50.0,5,9,0,9,2,18,2,0
Bologna,Jesper Karlsson,se SWE,FW,26.0,3.3,1,0,0,0,1,0,2,0.0,2,4,0,4,0,1,3,0
Bologna,Kacper Urbanski,pl POL,MF,19.0,2.8,5,2,4,0,1,4,6,66.7,2,5,1,4,2,7,5,0
Bologna,Samuel Iling-Junior,eng ENG,FW,20.0,1.3,3,2,1,1,1,0,1,0.0,1,1,0,1,2,5,2,0
Bologna,Oussama El Azzouzi,ma MAR,MF,23.0,0.2,0,0,0,0,0,0,0,,0,0,0,0,2,2,0,0
Bologna,Estanis,es ESP,FW,20.0,0.1,0,0,0,0,0,0,0,,0,0,0,0,0,0,0,0
Como,Gabriel Strefezza,br BRA,FW,27.0,29.3,57,39,20,20,17,21,55,38.2,34,24,2,22,13,70,26,0
Como,Nicolás Paz,ar ARG,MF,19.0,30.0,51,33,18,26,7,24,51,47.1,27,49,3,46,21,72,16,0
Como,Lucas Da Cunha,fr FRA,MF,23.0,29.2,45,25,17,19,9,20,39,51.3,19,18,3,15,17,62,30,1
Como,Marc-Oliver Kempf,de GER,DF,29.0,29.1,30,20,15,14,1,13,24,54.2,11,35,26,9,33,63,136,4
Como,Edoardo Goldaniga,it ITA,DF,30.0,28.1,34,21,21,8,5,13,18,72.2,5,21,10,11,33,67,102,3
Como,Patrick Cutrone,it ITA,FW,26.0,22.9,16,11,0,10,6,7,14,50.0,7,11,0,11,5,21,7,0
Como,Alberto Moreno,es ESP,DF,32.0,19.3,25,11,17,8,0,12,26,46.2,14,12,3,9,14,39,40,2
Como,Máximo Perrone,ar ARG,MF,21.0,20.7,38,27,19,14,5,13,38,34.2,25,15,2,13,20,58,43,0
Como,Alberto Dossena,it ITA,DF,25.0,20.3,33,20,23,8,2,16,28,57.1,12,22,11,11,22,55,89,1
Como,Alieu Fadera,gm GAM,"FW,DF",22.0,18.4,64,47,25,27,12,20,45,44.4,25,18,1,17,12,76,10,0
Como,Jean Butez,fr FRA,GK,29.0,18.5,0,0,0,0,0,0,2,0.0,2,0,0,0,0,0,18,1
Como,Maxence Caqueret,fr FRA,MF,24.0,12.2,36,21,14,18,4,20,38,52.6,18,15,1,14,7,43,4,1
Como,Ignace Van Der Brempt,be BEL,DF,22.0,14.0,40,32,27,10,3,24,33,72.7,9,14,5,9,17,57,34,0
Como,Assane Diao,sn SEN,FW,18.0,14.0,25,14,9,10,6,12,28,42.9,16,8,1,7,3,28,19,0
Como,Álex Valle,es ESP,DF,20.0,11.5,26,12,12,12,2,15,21,71.4,6,13,2,11,8,34,42,0
Como,Pepe Reina,es ESP,GK,41.0,11.5,0,0,0,0,0,0,1,0.0,1,0,0,0,0,0,3,2
Como,Yannik Engelhardt,de GER,MF,23.0,13.0,30,12,13,13,4,16,27,59.3,11,13,6,7,11,41,27,0
Como,Emil Audero,id IDN,GK,27.0,8.0,0,0,0,0,0,0,1,0.0,1,0,0,0,0,0,4,1
Como,Mërgim Vojvoda,xk KVX,DF,29.0,8.0,9,6,5,4,0,7,9,77.8,2,7,4,3,3,12,18,0
Como,Sergi Roberto,es ESP,MF,32.0,7.8,14,8,5,5,4,5,7,71.4,2,7,1,6,9,23,14,0
Como,Ivan Smolčić,hr CRO,DF,23.0,7.0,16,9,8,7,1,9,13,69.2,4,8,2,6,10,26,24,0
Como,Andrea Belotti,it ITA,FW,30.0,6.7,7,5,1,4,2,1,4,25.0,3,4,0,4,1,8,8,0
Como,Anastasios Douvikas,gr GRE,FW,24.0,6.5,3,2,0,3,0,1,4,25.0,3,3,0,3,1,4,3,0
Como,Jonathan Ikone,fr FRA,FW,26.0,6.1,15,9,4,3,8,6,11,54.5,5,5,1,4,0,15,1,1
Como,Federico Barba,it ITA,DF,30.0,4.8,2,2,1,1,0,1,4,25.0,3,2,2,0,4,6,15,0
Como,Alessio Iovine,it ITA,DF,33.0,4.3,5,2,2,3,0,4,10,40.0,6,7,1,6,3,8,21,1
Como,Luca Mazzitelli,it ITA,MF,28.0,3.8,9,6,4,5,0,5,7,71.4,2,5,2,3,3,12,10,0
Como,Matthias Braunöder,at AUT,MF,22.0,3.0,10,4,6,3,1,7,11,63.6,4,3,0,3,2,12,4,1
Como,Marco Sala,it ITA,DF,25.0,2.9,9,6,5,3,1,5,8,62.5,3,2,0,2,1,10,9,0
Como,Fellipe Jack,br BRA,DF,18.0,1.9,9,4,8,1,0,3,5,60.0,2,2,2,0,4,13,5,0
Como,Daniele Baselli,it ITA,MF,32.0,0.3,0,0,0,0,0,0,0,,0,0,0,0,1,1,1,0
Como,Alessandro Gabrielloni,it ITA,FW,30.0,1.6,0,0,0,0,0,0,3,0.0,3,0,0,0,0,0,1,0
Como,Simone Verdi,it ITA,MF,32.0,1.3,2,2,0,1,1,0,2,0.0,2,2,0,2,0,2,2,0
Como,Alberto Cerri,it ITA,FW,28.0,1.0,0,0,0,0,0,0,0,,0,2,0,2,0,0,1,0
Como,Ben Lhassine Kone,ci CIV,MF,24.0,0.6,2,2,1,0,1,2,3,66.7,1,0,0,0,1,3,1,0
Como,Ali Jasim,iq IRQ,"FW,DF",20.0,0.1,1,0,1,0,0,1,1,100.0,0,0,0,0,0,1,0,0
Como,Dele Alli,eng ENG,MF,28.0,0.1,0,0,0,0,0,0,0,,0,0,0,0,0,0,0,0
Como,Oliver Abildgaard,dk DEN,MF,28.0,0.1,0,0,0,0,0,0,0,,0,1,0,1,0,0,0,0
Torino,Vanja Milinković-Savić,rs SRB,GK,27.0,37.0,1,0,1,0,0,1,3,33.3,2,0,0,0,0,1,18,4
Torino,Samuele Ricci,it ITA,MF,22.0,31.5,35,21,15,14,6,18,28,64.3,10,23,9,14,25,60,51,2
Torino,Saúl Coco,gq EQG,DF,25.0,31.6,46,26,31,14,1,19,30,63.3,11,49,31,18,38,84,157,4
Torino,Che Adams,sct SCO,FW,28.0,29.6,12,6,2,4,6,1,7,14.3,6,13,6,7,2,14,18,0
Torino,Guillermo Maripán,cl CHI,DF,30.0,26.0,40,23,25,14,1,21,33,63.6,12,27,13,14,41,81,138,1
Torino,Valentino Lazaro,at AUT,DF,28.0,25.8,26,12,10,12,4,15,30,50.0,15,28,5,23,11,37,38,1
Torino,Nikola Vlašić,hr CRO,MF,26.0,23.6,37,19,11,17,9,12,30,40.0,18,15,3,12,9,46,15,0
Torino,Adam Masina,ma MAR,DF,30.0,21.4,33,15,22,10,1,23,40,57.5,17,28,15,13,27,60,95,2
Torino,Sebastian Walukiewicz,pl POL,DF,24.0,18.5,38,20,18,16,4,23,31,74.2,8,21,8,13,18,56,60,0
Torino,Karol Linetty,pl POL,MF,29.0,17.2,39,23,17,19,3,20,41,48.8,21,14,5,9,12,51,31,1
Torino,Antonio Sanabria,py PAR,FW,28.0,14.7,3,3,1,1,1,1,4,25.0,3,6,1,5,1,4,13,0
Torino,Gvidas Gineitis,lt LTU,MF,20.0,16.0,25,15,8,10,7,13,25,52.0,12,16,6,10,18,43,32,0
Torino,Marcus Pedersen,no NOR,DF,24.0,15.2,13,8,6,6,1,10,16,62.5,6,11,2,9,13,26,34,1
Torino,Borna Sosa,hr CRO,DF,26.0,13.2,26,19,14,7,5,16,25,64.0,9,13,6,7,14,40,33,0
Torino,Cristiano Biraghi,it ITA,DF,31.0,12.9,16,10,9,3,4,11,18,61.1,7,15,4,11,8,24,44,0
Torino,Cesare Casadei,it ITA,MF,21.0,11.4,12,5,4,8,0,5,10,50.0,5,4,2,2,5,17,26,0
Torino,Mërgim Vojvoda,xk KVX,DF,29.0,12.4,18,10,5,9,4,7,14,50.0,7,13,3,10,7,25,24,1
Torino,Elif Elmas,mk MKD,FW,24.0,11.4,10,7,3,5,2,4,10,40.0,6,8,2,6,6,16,5,2
Torino,Yann Karamoh,fr FRA,MF,26.0,11.7,5,2,2,1,2,4,9,44.4,5,10,2,8,3,8,5,0
Torino,Ivan Ilić,rs SRB,MF,23.0,10.3,5,2,0,4,1,2,8,25.0,6,0,0,0,5,10,10,0
Torino,Adrien Tameze,cm CMR,MF,30.0,7.3,5,2,2,3,0,1,10,10.0,9,8,5,3,10,15,8,1
Torino,Duván Zapata,co COL,FW,33.0,6.6,7,5,2,0,5,0,3,0.0,3,2,1,1,2,9,7,0
Torino,Ali Dembélé,fr FRA,DF,20.0,4.3,9,5,6,3,0,4,4,100.0,0,6,2,4,1,10,11,1
Torino,Alberto Paleari,it ITA,GK,31.0,1.0,0,0,0,0,0,0,0,,0,0,0,0,0,0,2,0
Torino,Raoul Bellanova,it ITA,DF,24.0,1.0,0,0,0,0,0,0,1,0.0,1,0,0,0,0,0,4,0
Torino,Eybi Nije,se SWE,FW,19.0,4.4,5,1,3,1,1,0,3,0.0,3,5,1,4,0,5,1,0
Torino,Sergiu Perciun,md MDA,FW,18.0,1.7,2,2,0,0,2,1,4,25.0,3,2,0,2,1,3,2,0
Torino,Alessio Cacciamani,it ITA,MF,17.0,0.3,0,0,0,0,0,0,0,,0,0,0,0,1,1,0,0
Torino,Tommaso Gabellini,it ITA,FW,17.0,0.1,0,0,0,0,0,0,0,,0,0,0,0,0,0,0,0
Torino,Saba Sazonov,ge GEO,DF,22.0,0.0,0,0,0,0,0,0,0,,0,1,1,0,0,0,0,0
Torino,Aaron Ciammaglichella,it ITA,MF,19.0,0.0,0,0,0,0,0,0,0,,0,0,0,0,0,0,0,0
Udinese,Jesper Karlström,se SWE,MF,29.0,35.5,61,34,32,21,8,25,51,49.0,26,28,11,17,35,96,82,5
Udinese,Jaka Bijol,si SVN,DF,25.0,32.9,43,25,32,10,1,21,40,52.5,19,38,18,20,38,81,182,1
Udinese,Sandi Lovrić,si SVN,MF,26.0,25.9,46,29,25,17,4,22,44,50.0,22,33,5,28,22,68,27,1
Udinese,Kingsley Ehizibue,nl NED,DF,29.0,27.9,55,35,31,18,6,25,41,61.0,16,41,14,27,23,78,70,5
Udinese,Lorenzo Lucca,it ITA,FW,23.0,26.3,10,6,3,2,5,5,11,45.5,6,18,1,17,7,17,27,0
Udinese,Maduka Okoye,ng NGA,GK,24.0,25.0,0,0,0,0,0,0,0,,0,0,0,0,0,0,12,1
Udinese,Hassane Kamara,ci CIV,DF,30.0,22.3,35,25,20,11,4,16,28,57.1,12,23,5,18,26,61,49,1
Udinese,Florian Thauvin,fr FRA,FW,31.0,21.9,20,14,9,8,3,10,25,40.0,15,6,0,6,7,27,10,0
Udinese,Jurgen Ekkelenkamp,nl NED,MF,24.0,21.2,36,25,10,22,4,18,35,51.4,17,26,4,22,12,48,26,0
Udinese,Thomas Kristensen,dk DEN,DF,22.0,19.5,31,21,16,11,4,20,32,62.5,12,18,13,5,21,52,80,2
Udinese,Oumar Solet,fr FRA,DF,24.0,18.6,33,19,18,13,2,21,30,70.0,9,32,19,13,17,50,78,4
Udinese,Martín Payero,ar ARG,MF,25.0,15.5,24,16,4,14,6,8,16,50.0,8,16,2,14,13,37,13,0
Udinese,Jordan Zemura,zw ZIM,DF,24.0,15.8,31,14,14,12,5,17,29,58.6,12,17,4,13,16,47,41,0
Udinese,Arthur Atta,fr FRA,MF,21.0,14.0,20,12,9,10,1,10,15,66.7,5,9,5,4,7,27,15,1
Udinese,Christian Kabasele,be BEL,DF,33.0,13.0,17,9,10,7,0,11,14,78.6,3,14,8,6,14,31,75,1
Udinese,Razvan Sava,ro ROU,GK,22.0,12.0,0,0,0,0,0,0,0,,0,0,0,0,0,0,6,2
Udinese,Lautaro Gianetti,ar ARG,DF,30.0,9.8,22,10,16,5,1,14,20,70.0,6,20,10,10,15,37,49,1
Udinese,Souleymane Touré,fr FRA,DF,21.0,8.2,7,6,4,3,0,4,5,80.0,1,15,6,9,9,16,17,1
Udinese,Keinan Davis,eng ENG,FW,26.0,11.9,9,4,1,4,4,3,6,50.0,3,2,1,1,1,10,5,0
Udinese,Oier Zarraga,es ESP,MF,25.0,10.0,19,13,7,10,2,10,22,45.5,12,9,5,4,2,21,8,0
Udinese,Alexis Sánchez,cl CHI,FW,35.0,4.9,3,1,0,2,1,1,7,14.3,6,5,0,5,4,7,1,1
Udinese,Brenner,br BRA,MF,24.0,4.3,6,4,2,3,1,3,8,37.5,5,4,0,4,1,7,6,0
Udinese,Iker Bravo,es ESP,FW,19.0,7.6,10,6,3,5,2,5,9,55.6,4,4,1,3,1,11,4,0
Udinese,Rui Modesto,ao ANG,DF,24.0,6.8,16,12,4,9,3,7,9,77.8,2,10,0,10,8,24,13,0
Udinese,Nehuén Pérez,ar ARG,DF,24.0,2.0,1,1,0,0,1,0,1,0.0,1,2,2,0,1,2,7,0
Udinese,Daniele Padelli,it ITA,GK,38.0,1.0,0,0,0,0,0,0,1,0.0,1,0,0,0,0,0,0,0
Udinese,Simone Pafundi,it ITA,MF,18.0,1.3,3,3,2,0,1,1,4,25.0,3,0,0,0,0,3,1,0
Udinese,Enzo Ebosse,cm CMR,DF,25.0,1.0,0,0,0,0,0,0,2,0.0,2,3,3,0,1,1,1,0
Udinese,James Abankwah,ie IRL,DF,20.0,1.0,4,2,4,0,0,2,3,66.7,1,2,1,1,1,5,3,0
Udinese,Damián Pizarro,cl CHI,FW,19.0,0.2,0,0,0,0,0,0,0,,0,0,0,0,0,0,0,0
Udinese,Matteo Palma,de GER,DF,16.0,0.1,0,0,0,0,0,0,0,,0,1,1,0,0,0,1,0
Genoa,Morten Frendrup,dk DEN,MF,23.0,34.5,102,61,23,52,27,34,78,43.6,44,62,16,46,47,149,57,0
Genoa,Aarón Martín,es ESP,DF,27.0,34.3,71,47,41,26,4,33,51,64.7,18,33,11,22,19,90,73,1
Genoa,Johan Vásquez,mx MEX,DF,25.0,33.8,56,31,24,27,5,26,44,59.1,18,59,31,28,50,106,150,1
Genoa,Andrea Pinamonti,it ITA,FW,25.0,31.8,10,6,0,7,3,2,8,25.0,6,16,4,12,1,11,28,2
Genoa,Nicola Leali,it ITA,GK,31.0,29.0,0,0,0,0,0,0,0,,0,0,0,0,0,0,14,1
Genoa,Koni De Winter,be BEL,DF,22.0,23.7,33,19,21,8,4,17,25,68.0,8,11,7,4,25,58,118,3
Genoa,Stefano Sabelli,it ITA,DF,31.0,23.0,58,31,27,25,6,20,52,38.5,32,28,7,21,22,80,65,0
Genoa,Morten Thorsby,no NOR,MF,28.0,21.2,49,30,19,20,10,17,29,58.6,12,22,1,21,5,54,28,1
Genoa,Fabio Miretti,it ITA,MF,20.0,18.8,28,15,6,14,8,18,33,54.5,15,20,1,19,7,35,13,2
Genoa,Milan Badelj,hr CRO,MF,35.0,16.5,29,16,14,10,5,15,35,42.9,20,19,7,12,20,49,43,0
Genoa,Alessandro Zanoli,it ITA,"FW,DF",23.0,19.2,29,20,11,14,4,10,23,43.5,13,20,3,17,12,41,40,0
Genoa,Mattia Bani,it ITA,DF,30.0,16.8,19,10,11,6,2,7,11,63.6,4,13,8,5,22,41,85,2
Genoa,Patrizio Masini,it ITA,MF,23.0,17.1,54,29,18,26,10,19,40,47.5,21,26,8,18,15,69,37,0
Genoa,Vitinha,pt POR,FW,24.0,14.9,23,8,12,6,5,11,30,36.7,19,14,2,12,12,35,22,0
Genoa,Alan Matturro,uy URU,DF,19.0,10.0,11,6,6,5,0,3,14,21.4,11,10,3,7,14,25,38,0
Genoa,Junior Messias,br BRA,MF,33.0,9.5,13,7,6,6,1,3,10,30.0,7,8,2,6,6,19,20,0
Genoa,Brooke Norton-Cuffy,eng ENG,DF,20.0,8.0,12,7,9,3,0,9,11,81.8,2,12,2,10,3,15,12,0
Genoa,Alessandro Vogliacco,it ITA,DF,25.0,8.0,15,3,7,7,1,10,12,83.3,2,11,7,4,9,24,20,0
Genoa,Pierluigi Gollini,it ITA,GK,29.0,7.0,0,0,0,0,0,0,0,,0,1,0,1,0,0,2,1
Genoa,Jeff Ekhator,it ITA,FW,17.0,8.6,7,4,4,1,2,4,9,44.4,5,10,1,9,2,9,5,0
Genoa,Ruslan Malinovskyi,ua UKR,MF,31.0,4.3,12,8,4,7,1,3,6,50.0,3,2,0,2,1,13,4,0
Genoa,Caleb Ekuban,gh GHA,FW,30.0,6.2,3,3,1,1,1,1,1,100.0,0,4,1,3,1,4,6,0
Genoa,Honest Ahanor,it ITA,DF,16.0,3.0,7,5,2,3,2,7,10,70.0,3,4,0,4,1,8,9,0
Genoa,Sebastian Otoa,dk DEN,DF,20.0,2.0,1,0,1,0,0,1,2,50.0,1,1,1,0,3,4,14,0
Genoa,Jean Onana,cm CMR,MF,24.0,3.4,12,6,2,10,0,5,9,55.6,4,6,1,5,4,16,8,1
Genoa,Maxwel Cornet,ci CIV,FW,27.0,2.7,2,1,1,0,1,0,1,0.0,1,1,1,0,2,4,2,0
Genoa,Lior Kasa,il ISR,MF,18.0,2.6,4,4,2,2,0,2,5,40.0,3,4,1,3,3,7,5,0
Genoa,Benjamin Siegrist,ch SUI,GK,32.0,1.7,0,0,0,0,0,0,0,,0,0,0,0,1,1,1,0
Genoa,Lorenzo Venturino,it ITA,FW,18.0,1.9,5,3,4,0,1,3,6,50.0,3,3,0,3,0,5,5,0
Genoa,Emil Bohinen,no NOR,MF,25.0,1.8,4,4,3,0,1,2,5,40.0,3,2,0,2,1,5,6,0
Genoa,Filippo Melegoni,it ITA,MF,25.0,1.0,1,1,1,0,0,0,4,0.0,4,0,0,0,0,1,2,0
Genoa,Alessandro Marcandalli,it ITA,DF,21.0,0.5,1,0,1,0,0,0,0,,0,0,0,0,0,1,2,0
Genoa,Mario Balotelli,it ITA,FW,33.0,0.7,0,0,0,0,0,0,0,,0,0,0,0,0,0,1,0
Genoa,David Akpan Ankeye,ng NGA,FW,22.0,0.5,0,0,0,0,0,0,1,0.0,1,0,0,0,0,0,1,0
Genoa,Gastón Pereiro,uy URU,MF,29.0,0.3,1,0,0,1,0,1,1,100.0,0,0,0,0,0,1,1,0
Genoa,Daniele Sommariva,it ITA,GK,27.0,0.3,0,0,0,0,0,0,0,,0,0,0,0,0,0,1,0
Genoa,Federico Accornero,it ITA,MF,20.0,0.1,0,0,0,0,0,0,0,,0,0,0,0,0,0,0,0
Hellas Verona,Lorenzo Montipò,it ITA,GK,28.0,36.0,1,0,1,0,0,1,4,25.0,3,0,0,0,0,1,24,4
Hellas Verona,Jackson Tchatchoua,cm CMR,DF,22.0,35.2,50,31,34,13,3,28,43,65.1,15,21,9,12,14,64,75,2
Hellas Verona,Diego Coppola,it ITA,DF,20.0,32.5,66,36,48,14,4,28,40,70.0,12,44,24,20,72,138,194,2
Hellas Verona,Ondrej Duda,sk SVK,MF,29.0,26.7,46,27,21,22,3,29,64,45.3,35,28,9,19,31,77,30,4
Hellas Verona,Tomáš Suslov,sk SVK,MF,22.0,23.3,54,38,23,24,7,23,72,31.9,49,30,2,28,18,72,17,1
Hellas Verona,Amin Sarr,se SWE,FW,23.0,21.4,22,12,3,8,11,5,10,50.0,5,18,3,15,3,25,14,0
Hellas Verona,Domagoj Bradarić,hr CRO,DF,24.0,21.6,36,28,21,11,4,18,29,62.1,11,17,4,13,15,51,49,1
Hellas Verona,Paweł Dawidowicz,pl POL,DF,29.0,20.5,45,24,20,22,3,18,27,66.7,9,16,6,10,20,65,70,2
Hellas Verona,Daniele Ghilardi,it ITA,DF,21.0,22.6,44,29,27,17,0,25,41,61.0,16,29,15,14,30,74,106,0
Hellas Verona,Casper Tengstedt,dk DEN,FW,24.0,17.1,7,5,0,5,2,4,9,44.4,5,5,1,4,4,11,29,0
Hellas Verona,Reda Belahyane,ma MAR,MF,20.0,18.5,36,26,16,13,7,13,17,76.5,4,20,9,11,10,46,22,1
Hellas Verona,Darko Lazović,rs SRB,DF,33.0,16.3,21,10,5,14,2,11,28,39.3,17,19,3,16,11,32,39,0
Hellas Verona,Suat Serdar,de GER,MF,27.0,15.4,35,22,12,19,4,10,26,38.5,16,19,4,15,8,43,21,0
Hellas Verona,Nicolás Valentini,ar ARG,DF,23.0,12.6,35,23,22,12,1,20,31,64.5,11,15,7,8,15,50,97,0
Hellas Verona,Daniel Mosquera,co COL,FW,24.0,15.4,11,8,3,5,3,1,15,6.7,14,11,1,10,2,13,10,0
Hellas Verona,Giangiacomo Magnani,it ITA,DF,28.0,11.8,20,15,14,6,0,7,7,100.0,0,16,9,7,17,37,73,1
Hellas Verona,Flavius Daniliuc,at AUT,DF,23.0,11.2,26,21,14,9,3,15,24,62.5,9,10,3,7,7,33,27,0
Hellas Verona,Dailon Livramento,cv CPV,FW,23.0,10.5,15,11,2,7,6,7,13,53.8,6,10,2,8,3,18,9,0
Hellas Verona,Grigoris Kastanos,cy CYP,MF,26.0,9.8,23,16,8,7,8,9,21,42.9,12,17,2,15,7,30,8,0
Hellas Verona,Cheikh Tidiane Niasse,sn SEN,MF,24.0,8.4,18,15,6,12,0,10,19,52.6,9,17,4,13,17,35,17,2
Hellas Verona,Antoine Bernede,fr FRA,MF,25.0,6.7,15,8,4,9,2,10,16,62.5,6,6,1,5,5,20,3,0
Hellas Verona,Martin Frese,dk DEN,DF,26.0,6.1,18,11,7,10,1,7,13,53.8,6,5,1,4,8,26,16,1
Hellas Verona,Abdou Harroui,nl NED,MF,26.0,5.2,9,6,6,3,0,4,4,100.0,0,5,0,5,2,11,5,0
Hellas Verona,Daniel Bandeira,pt POR,MF,24.0,4.5,4,0,1,3,0,3,6,50.0,3,2,1,1,6,10,8,0
Hellas Verona,Davide Faraoni,it ITA,DF,32.0,2.9,10,9,5,5,0,3,9,33.3,6,7,3,4,2,12,12,1
Hellas Verona,Simone Perilli,it ITA,GK,29.0,2.0,0,0,0,0,0,0,0,,0,0,0,0,0,0,1,0
Hellas Verona,Daniel Oyegoke,eng ENG,DF,21.0,1.1,2,2,1,0,1,1,1,100.0,0,1,0,1,1,3,7,0
Hellas Verona,Mathis Lambourde,fr FRA,FW,18.0,1.0,3,1,2,1,0,1,3,33.3,2,3,0,3,0,3,1,0
Hellas Verona,Faride Alidou,de GER,FW,23.0,0.8,0,0,0,0,0,0,0,,0,1,0,1,1,1,3,1
Hellas Verona,Junior Ajayi,ci CIV,FW,19.0,0.1,0,0,0,0,0,0,0,,0,0,0,0,0,0,0,0
Hellas Verona,Alphadjo Cissè,it ITA,FW,17.0,0.1,0,0,0,0,0,0,0,,0,0,0,0,0,0,0,0
Hellas Verona,Yllan Okou,fr FRA,DF,21.0,0.0,0,0,0,0,0,0,0,,0,1,0,1,0,0,0,0
Cagliari,Roberto Piccoli,it ITA,FW,23.0,34.9,13,9,2,6,5,3,12,25.0,9,12,4,8,3,16,31,0
Cagliari,Sebastiano Luperto,it ITA,DF,27.0,36.0,48,27,31,16,1,18,28,64.3,10,30,15,15,33,81,161,1
Cagliari,Gabriele Zappa,it ITA,DF,24.0,34.0,40,23,20,17,3,17,34,50.0,17,42,22,20,23,63,93,1
Cagliari,Nadir Zortea,it ITA,DF,25.0,30.3,30,14,16,12,2,14,37,37.8,23,11,0,11,19,49,47,2
Cagliari,Yerry Mina,co COL,DF,29.0,28.6,66,32,43,21,2,40,52,76.9,12,59,35,24,37,103,163,3
Cagliari,Tommaso Augello,it ITA,DF,29.0,30.3,49,28,28,17,4,30,43,69.8,13,23,8,15,16,65,109,2
Cagliari,Michel Ndary Adopo,fr FRA,MF,24.0,26.9,55,32,16,31,8,15,29,51.7,14,20,5,15,27,82,25,0
Cagliari,Antoine Makoumbou,cg CGO,MF,26.0,24.1,42,23,28,11,3,19,25,76.0,6,26,5,21,17,59,28,0
Cagliari,Zito Luvumbo,ao ANG,FW,22.0,18.0,10,6,4,3,3,6,19,31.6,13,5,0,5,4,14,4,0
Cagliari,Elia Caprile,it ITA,GK,22.0,18.0,1,0,1,0,0,0,2,0.0,2,0,0,0,0,1,9,1
Cagliari,Nicolas Viola,it ITA,FW,34.0,14.3,14,7,6,7,1,1,10,10.0,9,5,0,5,3,17,5,0
Cagliari,Alessandro Deiola,it ITA,MF,28.0,16.0,31,20,11,17,3,10,32,31.3,22,26,12,14,13,44,38,0
Cagliari,Răzvan Marin,ro ROU,MF,28.0,15.7,22,13,8,11,3,13,25,52.0,12,7,0,7,2,24,20,2
Cagliari,Simone Scuffet,it ITA,GK,28.0,13.0,0,0,0,0,0,0,1,0.0,1,0,0,0,0,0,8,2
Cagliari,Adam Obert,sk SVK,DF,21.0,12.0,31,18,12,17,2,16,27,59.3,11,19,7,12,23,54,48,2
Cagliari,José Luis Palomino,ar ARG,DF,34.0,12.0,27,15,16,9,2,15,21,71.4,6,21,11,10,22,49,46,0
Cagliari,Mattia Felici,it ITA,MF,23.0,10.4,17,12,8,7,2,4,11,36.4,7,10,0,10,7,24,7,1
Cagliari,Gianluca Gaetano,it ITA,MF,24.0,11.3,11,8,4,6,1,5,15,33.3,10,8,0,8,6,17,8,0
Cagliari,Matteo Prati,it ITA,MF,20.0,6.4,10,4,2,7,1,3,11,27.3,8,5,2,3,7,17,10,1
Cagliari,Alen Sherri,al ALB,GK,26.0,6.9,1,0,1,0,0,1,2,50.0,1,0,0,0,1,2,1,0
Cagliari,Paulo Azzi,br BRA,DF,30.0,4.8,11,9,3,6,2,5,9,55.6,4,5,2,3,5,16,11,0
Cagliari,Florinel Coman,ro ROU,FW,26.0,2.9,5,3,3,1,1,2,2,100.0,0,2,0,2,1,6,3,0
Cagliari,Leonardo Pavoletti,it ITA,FW,35.0,5.0,1,0,0,1,0,0,0,,0,4,1,3,0,1,3,0
Cagliari,Gianluca Lapadula,pe PER,FW,34.0,3.5,2,0,1,0,1,0,1,0.0,1,0,0,0,0,2,1,0
Cagliari,Mateusz Wieteska,pl POL,DF,27.0,2.0,1,0,0,1,0,1,1,100.0,0,3,2,1,7,8,6,0
Cagliari,Kingstone Mutandwa,zm ZAM,FW,21.0,1.4,0,0,0,0,0,0,0,,0,0,0,0,0,0,0,0
Cagliari,Giuseppe Ciocci,it ITA,GK,22.0,0.1,0,0,0,0,0,0,0,,0,0,0,0,0,0,0,0
Cagliari,Nicola Pintus,it ITA,DF,19.0,0.0,0,0,0,0,0,0,0,,0,0,0,0,0,0,2,0
Parma,Zion Suzuki,jp JPN,GK,21.0,36.8,1,0,1,0,0,1,2,50.0,1,0,0,0,0,1,35,4
Parma,Simon Sohm,ch SUI,MF,23.0,33.3,28,17,11,13,4,16,35,45.7,19,11,3,8,26,54,36,0
Parma,Emanuele Valeri,it ITA,DF,25.0,32.0,51,31,33,15,3,30,61,49.2,31,31,10,21,29,80,103,4
Parma,Enrico Del Prato,it ITA,DF,24.0,32.8,33,17,24,8,1,19,26,73.1,7,69,35,34,19,52,132,2
Parma,Ange-Yoan Bonny,fr FRA,FW,20.0,28.3,34,16,4,23,7,8,14,57.1,6,17,2,15,3,37,17,0
Parma,Mandela Keita,be BEL,MF,22.0,20.4,44,25,13,25,6,18,35,51.4,17,18,7,11,21,65,29,2
Parma,Botond Balogh,hu HUN,DF,22.0,22.9,36,16,22,13,1,20,28,71.4,8,34,26,8,25,61,141,2
Parma,Dennis Man,ro ROU,FW,25.0,22.3,13,6,7,3,3,6,24,25.0,18,15,3,12,8,21,11,0
Parma,Matteo Cancellieri,it ITA,FW,22.0,16.0,26,16,15,9,2,11,32,34.4,21,15,1,14,13,39,30,0
Parma,Lautaro Valenti,ar ARG,DF,25.0,17.3,17,12,13,3,1,7,9,77.8,2,26,13,13,13,30,94,1
Parma,Adrian Bernabe,es ESP,MF,23.0,16.3,29,18,16,9,4,14,32,43.8,18,22,9,13,7,36,26,1
Parma,Valentin Mihaila,ro ROU,FW,24.0,14.4,29,15,8,13,8,9,22,40.9,13,18,0,18,8,37,6,0
Parma,Hernani,br BRA,MF,30.0,14.8,47,26,25,18,4,27,50,54.0,23,26,6,20,19,66,12,1
Parma,Giovanni Leoni,it ITA,DF,17.0,13.4,14,6,10,4,0,5,10,50.0,5,20,11,9,15,29,63,1
Parma,Woyo Coulibaly,ml MLI,DF,25.0,12.1,13,10,9,2,2,5,11,45.5,6,19,2,17,8,21,25,0
Parma,Antoine Hainaut,fr FRA,DF,22.0,13.5,26,14,15,8,3,9,13,69.2,4,17,4,13,15,41,59,1
Parma,Pontus Almqvist,se SWE,FW,25.0,12.4,17,13,7,7,3,8,17,47.1,9,13,0,13,19,36,8,0
Parma,Alessandro Vogliacco,it ITA,DF,25.0,8.6,5,2,5,0,0,3,5,60.0,2,15,10,5,3,8,37,0
Parma,Mateo Pellegrino,ar ARG,FW,23.0,8.3,3,2,1,2,0,1,4,25.0,3,6,1,5,1,4,6,0
Parma,Nahuel Estévez,ar ARG,MF,28.0,7.4,16,6,7,8,1,6,15,40.0,9,9,2,7,3,19,26,0
Parma,Alessandro Circati,au AUS,DF,20.0,6.0,7,5,6,1,0,1,2,50.0,1,5,4,1,3,10,42,1
Parma,Mohamed Haj,tn TUN,MF,19.0,5.0,3,1,2,1,0,1,2,50.0,1,3,1,2,4,7,5,0
Parma,Jacob Ondrejka,se SWE,MF,21.0,4.7,12,6,5,7,0,10,12,83.3,2,2,0,2,7,19,2,0
Parma,Milan Đurić,ba BIH,FW,34.0,3.0,0,0,0,0,0,0,2,0.0,2,3,0,3,0,0,2,0
Parma,Adrian Benedyczak,pl POL,FW,23.0,2.4,0,0,0,0,0,0,1,0.0,1,3,1,2,0,0,8,0
Parma,Yordan Osorio,ve VEN,DF,30.0,1.9,5,3,4,1,0,2,2,100.0,0,3,1,2,4,9,6,1
Parma,Drissa Camara,ci CIV,MF,22.0,5.0,9,7,2,6,1,1,10,10.0,9,8,0,8,3,12,1,0
Parma,Leandro Chichizola,ar ARG,GK,34.0,1.0,0,0,0,0,0,0,0,,0,0,0,0,0,0,2,0
Parma,Mateusz Kowalski,pl POL,MF,19.0,0.6,0,0,0,0,0,0,0,,0,1,0,1,0,0,1,0
Parma,Gabriel Charpentier,cg CGO,FW,25.0,3.0,4,3,2,1,1,3,4,75.0,1,3,0,3,0,4,9,0
Parma,Mathias Løvik,no NOR,DF,20.0,1.0,1,0,0,1,0,1,3,33.3,2,1,1,0,2,3,3,0
Parma,Wylan Cyprien,fr FRA,MF,29.0,0.3,0,0,0,0,0,0,1,0.0,1,1,0,1,1,1,0,0
Lecce,Federico Baschirotto,it ITA,DF,27.0,38.0,37,25,30,5,2,22,28,78.6,6,44,32,12,23,60,237,2
Lecce,Wladimiro Falcone,it ITA,GK,29.0,38.0,0,0,0,0,0,0,0,,0,0,0,0,0,0,29,3
Lecce,Nikola Krstović,me MNE,FW,24.0,34.1,18,9,4,7,7,7,16,43.8,9,12,7,5,7,25,24,0
Lecce,Antonino Gallo,it ITA,DF,24.0,29.0,65,42,46,15,4,34,62,54.8,28,33,6,27,20,85,133,0
Lecce,Frederic Guilbert,fr FRA,DF,29.0,27.2,65,36,30,29,6,36,55,65.5,19,28,8,20,47,112,113,3
Lecce,Lassana Coulibaly,ml MLI,MF,28.0,29.8,48,29,16,28,4,24,61,39.3,37,45,12,33,18,66,46,1
Lecce,Kialonda,ao ANG,DF,26.0,23.8,34,12,24,10,0,12,17,70.6,5,44,28,16,32,66,132,1
Lecce,Tete Morente,es ESP,FW,27.0,22.6,27,17,10,11,6,10,36,27.8,26,16,1,15,14,41,31,1
Lecce,Santiago Pierotti,ar ARG,FW,23.0,21.7,46,24,22,18,6,23,51,45.1,28,31,5,26,14,60,32,0
Lecce,Patrick Dorgu,dk DEN,DF,19.0,20.5,45,27,21,19,5,23,45,51.1,22,24,6,18,18,63,42,2
Lecce,Ylber Ramadani,al ALB,MF,28.0,20.2,51,28,24,27,0,33,52,63.5,19,26,9,17,24,75,26,3
Lecce,Balthazar Pierret,fr FRA,MF,24.0,19.3,51,31,25,23,3,13,30,43.3,17,19,5,14,19,70,31,1
Lecce,Gaby Jean,fr FRA,DF,24.0,15.5,14,7,8,5,1,6,11,54.5,5,13,10,3,9,23,71,1
Lecce,Hamza Rafia,tn TUN,MF,25.0,11.9,44,27,14,25,5,15,32,46.9,17,7,2,5,4,48,18,1
Lecce,Þórir Jóhann Helgason,is ISL,MF,23.0,12.9,10,7,3,6,1,7,13,53.8,6,7,2,5,6,16,11,2
Lecce,Ante Rebić,hr CRO,FW,30.0,8.8,12,9,5,5,2,3,9,33.3,6,7,1,6,2,14,4,1
Lecce,Medon Berisha,al ALB,MF,20.0,8.0,12,8,7,3,2,4,8,50.0,4,6,0,6,11,23,5,2
Lecce,Lameck Banda,zm ZAM,FW,23.0,6.8,8,5,4,2,2,3,12,25.0,9,7,0,7,2,10,8,1
Lecce,Jesper Karlsson,se SWE,FW,26.0,5.6,3,2,3,0,0,2,8,25.0,6,2,0,2,0,3,4,0
Lecce,Remi Oudin,fr FRA,MF,27.0,3.3,3,1,1,1,1,2,4,50.0,2,6,2,4,2,5,1,0
Lecce,Mohamed Kaba,fr FRA,MF,22.0,5.0,13,8,7,5,1,8,10,80.0,2,11,4,7,4,17,10,1
Lecce,Danilo Veiga,pt POR,DF,21.0,4.2,8,6,4,4,0,6,13,46.2,7,5,0,5,4,12,14,0
Lecce,Konan N'dri,ci CIV,FW,23.0,3.4,3,3,0,0,3,2,3,66.7,1,4,0,4,1,4,0,0
Lecce,Valentin Gendrey,fr FRA,DF,24.0,2.0,2,2,1,0,1,1,1,100.0,0,3,1,2,2,4,1,0
Lecce,Andy Pelmard,fr FRA,DF,24.0,1.4,6,6,5,1,0,4,4,100.0,0,1,0,1,0,6,5,0
Lecce,Tiago Gabriel,pt POR,DF,19.0,1.1,0,0,0,0,0,0,0,,0,4,2,2,0,0,11,0
Lecce,Marco Sala,it ITA,DF,25.0,0.8,1,0,0,1,0,0,1,0.0,1,1,0,1,0,1,0,0
Lecce,Kevin Bonifazi,it ITA,DF,28.0,0.7,1,1,1,0,0,1,1,100.0,0,1,1,0,2,3,3,0
Lecce,Nicola Sansone,it ITA,MF,32.0,0.7,0,0,0,0,0,0,0,,0,0,0,0,0,0,0,0
Lecce,Rareș-Cătălin Burnete,ro ROU,FW,20.0,0.3,0,0,0,0,0,0,1,0.0,1,0,0,0,0,0,0,0
Lecce,Filip Marchwiński,pl POL,MF,22.0,0.2,0,0,0,0,0,0,0,,0,0,0,0,0,0,0,0
Empoli,Emmanuel Gyasi,gh GHA,DF,30.0,35.8,52,29,32,14,6,24,38,63.2,14,27,9,18,11,63,77,0
Empoli,Giuseppe Pezzella,it ITA,DF,26.0,32.1,55,31,28,17,10,29,57,50.9,28,32,8,24,15,70,110,2
Empoli,Devis Vásquez,co COL,GK,26.0,32.0,0,0,0,0,0,0,0,,0,0,0,0,0,0,21,4
Empoli,Mattia Viti,it ITA,DF,22.0,28.6,65,45,42,20,3,34,52,65.4,18,41,18,23,48,113,128,4
Empoli,Saba Goglichidze,ge GEO,DF,20.0,28.3,64,37,36,25,3,25,51,49.0,26,36,17,19,33,97,97,3
Empoli,Ardian Ismajli,al ALB,DF,27.0,27.9,30,23,21,9,0,16,20,80.0,4,35,24,11,56,86,249,3
Empoli,Liam Henderson,sct SCO,MF,28.0,26.2,42,22,17,22,3,22,53,41.5,31,19,5,14,15,57,42,0
Empoli,Sebastiano Esposito,it ITA,FW,22.0,26.1,57,29,15,31,11,18,35,51.4,17,20,2,18,12,69,14,0
Empoli,Alberto Grassi,it ITA,MF,29.0,24.6,39,21,16,18,5,14,22,63.6,8,22,12,10,33,72,43,1
Empoli,Lorenzo Colombo,it ITA,FW,22.0,25.0,31,14,7,16,8,7,21,33.3,14,33,2,31,2,33,16,1
Empoli,Liberato Cacace,nz NZL,MF,23.0,24.9,37,25,20,13,4,22,31,71.0,9,26,9,17,22,59,59,0
Empoli,Youssef Maleh,ma MAR,MF,25.0,16.9,45,23,17,23,5,17,34,50.0,17,25,6,19,16,61,25,0
Empoli,Jacopo Fazzini,it ITA,MF,21.0,15.5,32,19,11,16,5,13,23,56.5,10,13,1,12,6,38,24,0
Empoli,Faustino Anjorin,eng ENG,MF,22.0,12.5,29,13,9,14,6,9,18,50.0,9,18,3,15,13,42,20,0
Empoli,Luca Marianucci,it ITA,DF,20.0,11.9,28,12,17,11,0,11,19,57.9,8,16,8,8,19,47,63,1
Empoli,Ola Solbakken,no NOR,MF,25.0,8.5,7,4,0,6,1,3,6,50.0,3,0,0,0,2,9,8,0
Empoli,Mattia De Sciglio,it ITA,DF,31.0,8.6,18,13,10,8,0,14,17,82.4,3,10,3,7,8,26,35,1
Empoli,Christian Kouamé,ci CIV,FW,26.0,5.7,5,4,0,3,2,2,4,50.0,2,4,2,2,0,5,4,0
Empoli,Marco Silvestri,it ITA,GK,33.0,5.0,0,0,0,0,0,0,2,0.0,2,0,0,0,0,0,3,1
Empoli,Pietro Pellegri,it ITA,FW,23.0,4.7,7,2,0,6,1,2,4,50.0,2,2,0,2,0,7,3,0
Empoli,Junior Sambia,fr FRA,DF,27.0,4.3,14,10,3,6,5,11,11,100.0,0,3,0,3,2,16,5,0
Empoli,Nicolas Haas,ch SUI,MF,28.0,3.2,11,8,4,5,2,5,9,55.6,4,2,1,1,4,15,6,0
Empoli,Sebastian Walukiewicz,pl POL,DF,24.0,2.0,1,0,1,0,0,0,1,0.0,1,3,3,0,1,2,15,0
Empoli,Jacopo Seghetti,it ITA,GK,19.0,1.0,0,0,0,0,0,0,0,,0,0,0,0,0,0,0,0
Empoli,Emmanuel Ekong,se SWE,MF,22.0,2.1,4,3,0,2,2,3,3,100.0,0,2,1,1,1,5,1,0
Empoli,Ismael Konate,ci CIV,FW,18.0,1.3,4,2,4,0,0,2,3,66.7,1,3,2,1,0,4,1,0
Empoli,Szymon Żurkowski,pl POL,MF,26.0,1.2,6,4,2,4,0,4,4,100.0,0,3,0,3,1,7,2,0
Empoli,Viktor Kovalenko,ua UKR,MF,28.0,0.9,2,1,0,2,0,0,1,0.0,1,0,0,0,0,2,0,0
Empoli,Tyronne Ebuehi,ng NGA,DF,28.0,0.8,3,2,1,2,0,1,1,100.0,0,1,0,1,2,5,0,0
Empoli,Jacopo Bacci,it ITA,MF,19.0,0.3,1,0,1,0,0,1,1,100.0,0,0,0,0,1,2,1,0
Empoli,Thomas Campaniello,it ITA,FW,16.0,0.3,0,0,0,0,0,0,2,0.0,2,0,0,0,0,0,0,0
Empoli,Francesco Caputo,it ITA,FW,36.0,0.1,0,0,0,0,0,0,0,,0,0,0,0,0,0,0,0
Empoli,Petar Stojanović,si SVN,MF,28.0,0.0,0,0,0,0,0,0,0,,0,0,0,0,0,0,0,0
Empoli,Lorenzo Tosto,it ITA,DF,18.0,0.0,0,0,0,0,0,0,0,,0,0,0,0,0,0,0,0
Venezia,Jay Idzes,id IDN,DF,24.0,34.8,45,29,24,17,4,17,33,51.5,16,52,32,20,32,77,156,0
Venezia,Hans Nicolussi Caviglia,it ITA,MF,24.0,31.9,47,28,17,22,8,29,64,45.3,35,39,12,27,28,75,55,2
Venezia,Mikael Ellertsson,is ISL,DF,22.0,27.6,58,26,37,14,7,33,61,54.1,28,42,5,37,17,75,79,0
Venezia,Gaetano Oristanio,it ITA,FW,21.0,26.0,17,13,5,8,4,7,15,46.7,8,16,0,16,6,23,6,1
Venezia,Gianluca Busio,us USA,MF,22.0,28.1,46,31,24,12,10,20,47,42.6,27,36,8,28,19,65,52,0
Venezia,Joel Pohjanpalo,fi FIN,FW,29.0,18.0,3,3,1,2,0,0,4,0.0,4,7,4,3,4,7,24,0
Venezia,Francesco Zampano,it ITA,DF,30.0,18.3,31,20,19,10,2,14,31,45.2,17,21,1,20,6,37,29,2
Venezia,Fali Candé,gw GNB,DF,26.0,17.0,25,19,14,10,1,16,23,69.6,7,21,15,6,15,40,90,2
Venezia,Alessio Zerbin,it ITA,DF,25.0,16.9,51,28,30,12,9,29,52,55.8,23,28,3,25,15,66,25,1
Venezia,Filip Stankovic,rs SRB,GK,22.0,15.2,0,0,0,0,0,0,0,,0,0,0,0,0,0,11,2
Venezia,Ionuț Radu,ro ROU,GK,27.0,15.0,0,0,0,0,0,0,0,,0,0,0,0,0,0,9,0
Venezia,Michael Svoboda,at AUT,DF,25.0,14.6,26,14,19,6,1,8,19,42.1,11,19,11,8,22,48,66,2
Venezia,Ridgeciano Haps,sr SUR,DF,31.0,15.3,30,16,19,8,3,14,22,63.6,8,18,3,15,7,37,48,0
Venezia,Kike Pérez,es ESP,MF,27.0,12.5,41,25,18,12,11,18,44,40.9,26,14,2,12,10,51,15,0
Venezia,Joël Schingtienne,be BEL,DF,21.0,12.5,27,16,18,7,2,12,19,63.2,7,18,9,9,14,41,25,5
Venezia,Marin Šverko,hr CRO,DF,26.0,12.5,20,9,14,6,0,10,12,83.3,2,10,5,5,16,36,45,3
Venezia,Antonio Candela,it ITA,DF,24.0,11.3,31,21,13,11,7,18,26,69.2,8,7,5,2,8,39,22,2
Venezia,Alfred Duncan,gh GHA,MF,31.0,10.7,17,8,4,11,2,5,14,35.7,9,7,2,5,8,25,8,0
Venezia,John Yeboah,ec ECU,FW,24.0,13.7,6,3,1,3,2,1,10,10.0,9,4,0,4,4,10,2,0
Venezia,Issa Doumbia,ci CIV,MF,20.0,10.5,14,8,6,7,1,7,17,41.2,10,17,5,12,9,23,14,1
Venezia,Giorgio Altare,it ITA,DF,25.0,8.4,13,12,8,3,2,8,15,53.3,7,21,11,10,17,30,49,0
Venezia,Jesse Joronen,fi FIN,GK,31.0,7.8,0,0,0,0,0,0,0,,0,0,0,0,0,0,4,1
Venezia,Magnus Kofod Andersen,dk DEN,MF,25.0,7.8,13,4,3,9,1,4,10,40.0,6,7,2,5,6,19,12,0
Venezia,Christian Gytkjær,dk DEN,FW,34.0,8.4,6,4,2,2,2,1,2,50.0,1,3,1,2,0,6,8,0
Venezia,Daniel Fila,cz CZE,FW,21.0,5.5,2,0,0,1,1,0,2,0.0,2,6,0,6,0,2,5,0
Venezia,Alessandro Marcandalli,it ITA,DF,21.0,4.0,8,6,6,2,0,3,6,50.0,3,6,3,3,2,10,26,0
Venezia,Mirko Marić,hr CRO,FW,29.0,4.0,6,3,5,1,0,2,5,40.0,3,3,1,2,1,7,10,0
Venezia,Franco Carboni,it ITA,DF,21.0,2.5,5,3,5,0,0,5,8,62.5,3,1,1,0,0,5,11,0
Venezia,Richie Sagrado,be BEL,DF,20.0,1.6,2,2,1,1,0,1,1,100.0,0,1,0,1,3,5,4,0
Venezia,Bjarki Bjarkason,is ISL,DF,24.0,1.8,3,2,2,1,0,1,2,50.0,1,1,0,1,2,5,4,0
Venezia,Cheick Oumar Conde,gn GUI,MF,24.0,1.7,6,5,3,2,1,2,5,40.0,3,7,2,5,4,10,3,0
Venezia,Domen Črnigoj,si SVN,MF,28.0,1.5,4,2,0,1,3,1,2,50.0,1,5,2,3,4,8,4,0
Venezia,Antonio Raimondo,it ITA,"FW,DF",20.0,1.0,2,1,1,1,0,0,0,,0,0,0,0,0,2,0,1
Venezia,Nicholas Pierini,it ITA,MF,25.0,0.9,0,0,0,0,0,0,1,0.0,1,2,0,2,0,0,0,0
Venezia,Saad El Haddad,ma MAR,MF,19.0,0.3,0,0,0,0,0,0,0,,0,0,0,0,0,0,0,0
Venezia,Nunzio Lella,it ITA,MF,24.0,0.1,0,0,0,0,0,0,0,,0,0,0,0,0,0,0,0
Monza,Giorgos Kyriakopoulos,gr GRE,DF,28.0,31.7,43,26,20,18,5,30,61,49.2,31,28,10,18,23,66,79,0
Monza,Pedro Pereira,pt POR,DF,26.0,29.7,53,32,30,18,5,35,55,63.6,20,26,12,14,21,74,85,5
Monza,Stefano Turati,it ITA,GK,22.0,29.7,0,0,0,0,0,0,1,0.0,1,0,0,0,0,0,21,2
Monza,Alessandro Bianco,it ITA,MF,21.0,29.0,51,28,26,17,8,27,41,65.9,14,40,14,26,22,73,53,4
Monza,Armando Izzo,it ITA,DF,32.0,27.1,40,15,30,9,1,18,36,50.0,18,38,28,10,45,85,101,0
Monza,Andrea Carboni,it ITA,DF,23.0,24.4,60,35,39,17,4,35,53,66.0,18,31,16,15,27,87,106,4
Monza,Dany Mota,pt POR,FW,26.0,23.5,13,3,2,3,8,4,8,50.0,4,18,1,17,9,22,27,3
Monza,Pablo Marí,es ESP,DF,30.0,18.1,26,15,14,12,0,11,21,52.4,10,24,21,3,37,63,85,2
Monza,Warren Bondo,fr FRA,MF,20.0,18.0,35,24,19,12,4,13,19,68.4,6,16,6,10,5,40,8,4
Monza,Gianluca Caprari,it ITA,MF,31.0,18.5,19,11,8,8,3,7,14,50.0,7,14,0,14,8,27,2,1
Monza,Samuele Birindelli,it ITA,DF,25.0,16.4,22,15,13,4,5,6,14,42.9,8,15,2,13,10,32,34,2
Monza,Daniel Maldini,it ITA,MF,22.0,14.6,14,6,5,9,0,6,13,46.2,7,8,2,6,4,18,12,2
Monza,Milan Đurić,ba BIH,FW,34.0,14.2,1,1,0,1,0,0,3,0.0,3,6,0,6,2,3,17,0
Monza,Patrick Ciurria,it ITA,MF,29.0,12.4,22,14,11,7,4,4,11,36.4,7,13,3,10,6,28,22,0
Monza,Danilo D'Ambrosio,it ITA,DF,35.0,12.2,28,15,17,10,1,14,23,60.9,9,12,8,4,15,43,36,2
Monza,Jean-Daniel Akpa-Akpro,ci CIV,MF,31.0,10.8,30,18,15,14,1,9,21,42.9,12,19,6,13,13,43,16,1
Monza,Luca Caldirola,it ITA,DF,33.0,9.8,11,7,8,3,0,4,7,57.1,3,9,6,3,11,22,43,1
Monza,Matteo Pessina,it ITA,MF,27.0,9.5,15,4,3,11,1,9,14,64.3,5,6,0,6,12,27,7,0
Monza,Semuel Pizzignacco,it ITA,GK,22.0,8.2,0,0,0,0,0,0,1,0.0,1,0,0,0,0,0,6,0
Monza,Keita Baldé,sn SEN,FW,29.0,7.2,1,1,0,1,0,1,2,50.0,1,4,0,4,2,3,0,0
Monza,Gaetano Castrovilli,it ITA,MF,27.0,6.7,12,7,10,2,0,4,11,36.4,7,8,2,6,2,14,9,0
Monza,Kacper Urbanski,pl POL,MF,19.0,5.6,5,3,1,2,2,4,7,57.1,3,7,2,5,2,7,9,0
Monza,Tomás Palacios,ar ARG,DF,21.0,5.0,11,5,9,2,0,9,13,69.2,4,7,2,5,8,19,17,2
Monza,Kevin Zeroli,it ITA,MF,19.0,4.4,6,2,3,3,0,0,1,0.0,1,6,1,5,2,8,11,0
Monza,Silvère Ganvoula M'Boussy,cg CGO,FW,28.0,3.6,0,0,0,0,0,0,1,0.0,1,1,0,1,1,1,5,0
Monza,Samuele Vignato,it ITA,MF,20.0,5.3,6,3,0,4,2,3,7,42.9,4,1,0,1,0,6,6,0
Monza,Stefan Lekovic,rs SRB,DF,20.0,4.1,9,4,6,2,1,5,13,38.5,8,4,4,0,7,16,5,0
Monza,Arvid Brorsson,se SWE,DF,25.0,4.0,4,3,2,2,0,2,5,40.0,3,9,8,1,2,6,35,1
Monza,Andrea Petagna,it ITA,FW,29.0,3.7,2,1,0,1,1,1,2,50.0,1,0,0,0,1,3,2,0
Monza,Stefano Sensi,it ITA,MF,28.0,3.1,8,5,4,4,0,5,6,83.3,1,4,2,2,3,11,3,1
Monza,Omari Forson,eng ENG,MF,20.0,2.5,3,3,1,2,0,1,3,33.3,2,3,0,3,1,4,1,0
Monza,Kevin Martins,it ITA,MF,19.0,2.0,5,4,3,2,0,3,6,50.0,3,1,0,1,1,6,4,1
Monza,Mirko Marić,hr CRO,FW,29.0,1.2,1,0,1,0,0,1,2,50.0,1,1,1,0,1,2,1,0
Monza,Roberto Gagliardini,it ITA,MF,30.0,2.0,3,2,1,2,0,1,4,25.0,3,1,0,1,2,5,4,0
Monza,Mattia Valoti,it ITA,MF,30.0,0.4,3,3,3,0,0,0,2,0.0,2,2,0,2,0,3,2,0
Monza,Andrea Mazza,it ITA,GK,20.0,0.1,0,0,0,0,0,0,0,,0,0,0,0,0,0,0,0
Bayern Munich,Joshua Kimmich,de GER,MF,29.0,31.6,47,29,11,29,7,30,50,60.0,20,23,3,20,25,72,34,3
Bayern Munich,Harry Kane,eng ENG,FW,31.0,26.6,13,11,3,8,2,2,6,33.3,4,16,2,14,2,15,16,0
Bayern Munich,Michael Olise,fr FRA,FW,22.0,26.1,36,23,10,21,5,17,38,44.7,21,23,1,22,8,44,16,2
Bayern Munich,Kim Min-jae,kr KOR,DF,27.0,25.4,35,20,18,13,4,11,21,52.4,10,23,10,13,37,72,91,4
Bayern Munich,Manuel Neuer,de GER,GK,38.0,22.0,1,0,1,0,0,1,1,100.0,0,0,0,0,0,1,9,1
Bayern Munich,Jamal Musiala,de GER,MF,21.0,20.1,36,21,7,16,13,12,29,41.4,17,30,0,30,8,44,5,1
Bayern Munich,Dayot Upamecano,fr FRA,DF,25.0,19.6,36,22,18,16,2,16,29,55.2,13,17,7,10,34,70,45,1
Bayern Munich,Konrad Laimer,at AUT,DF,27.0,18.9,49,27,19,22,8,23,48,47.9,25,24,1,23,8,57,24,1
Bayern Munich,Raphaël Guerreiro,pt POR,DF,30.0,17.6,19,12,9,7,3,12,16,75.0,4,9,0,9,10,29,19,1
Bayern Munich,Aleksandar Pavlovic,de GER,MF,20.0,16.2,38,21,13,15,10,22,32,68.8,10,18,3,15,5,43,14,0
Bayern Munich,Leroy Sané,de GER,FW,28.0,18.3,23,15,4,8,11,12,23,52.2,11,8,0,8,7,30,3,0
Bayern Munich,Alphonso Davies,ca CAN,DF,23.0,17.4,30,17,7,17,6,17,26,65.4,9,14,1,13,13,43,22,2
Bayern Munich,Eric Dier,eng ENG,DF,30.0,16.3,19,11,8,9,2,13,20,65.0,7,19,8,11,20,39,77,1
Bayern Munich,Kingsley Coman,fr FRA,FW,28.0,14.4,17,12,6,6,5,8,12,66.7,4,12,0,12,8,25,15,0
Bayern Munich,Leon Goretzka,de GER,MF,29.0,14.8,21,11,5,12,4,10,20,50.0,10,27,7,20,20,41,25,1
Bayern Munich,Serge Gnabry,de GER,FW,29.0,13.9,20,11,6,7,7,8,12,66.7,4,11,0,11,6,26,9,0
Bayern Munich,Thomas Müller,de GER,MF,34.0,13.7,8,5,2,3,3,4,16,25.0,12,10,0,10,2,10,14,0
Bayern Munich,Josip Stanišić,hr CRO,DF,24.0,9.7,13,11,6,4,3,7,15,46.7,8,10,6,4,6,19,29,1
Bayern Munich,Jonas Urbig,de GER,GK,20.0,8.0,0,0,0,0,0,0,0,,0,0,0,0,0,0,9,2
Bayern Munich,João Palhinha,pt POR,MF,29.0,7.5,20,14,6,11,3,11,16,68.8,5,13,1,12,4,24,9,1
Bayern Munich,Sacha Boey,fr FRA,DF,23.0,6.6,20,5,6,6,8,13,18,72.2,5,6,0,6,2,22,14,0
Bayern Munich,Daniel Peretz,il ISR,GK,24.0,3.0,0,0,0,0,0,0,1,0.0,1,0,0,0,0,0,2,0
Bayern Munich,Hiroki Ito,jp JPN,DF,25.0,2.8,2,0,1,1,0,1,1,100.0,0,3,2,1,6,8,15,1
Bayern Munich,Mathys Tel,fr FRA,FW,19.0,2.9,2,2,0,2,0,0,0,,0,0,0,0,1,3,1,0
Bayern Munich,Sven Ulreich,de GER,GK,35.0,1.0,0,0,0,0,0,0,0,,0,0,0,0,0,0,0,0
Bayern Munich,Gabriel Vidovic,hr CRO,MF,20.0,0.3,0,0,0,0,0,0,0,,0,2,0,2,0,0,0,0
Bayern Munich,Adam Aznou,ma MAR,DF,18.0,0.2,0,0,0,0,0,0,0,,0,0,0,0,0,0,1,0
Bayern Munich,Jonah Kusi-Asare,se SWE,FW,17.0,0.0,1,0,0,0,1,0,0,,0,0,0,0,0,1,0,0
Bayern Munich,Arijon Ibrahimović,de GER,FW,18.0,0.0,0,0,0,0,0,0,0,,0,0,0,0,0,0,0,0
Bayer Leverkusen,Jonathan Tah,de GER,DF,28.0,33.0,19,12,12,6,1,10,16,62.5,6,22,16,6,36,55,157,2
Bayer Leverkusen,Granit Xhaka,ch SUI,MF,31.0,32.1,48,26,15,27,6,24,42,57.1,18,30,7,23,12,60,52,6
Bayer Leverkusen,Álex Grimaldo,es ESP,DF,28.0,29.4,24,14,13,7,4,16,42,38.1,26,22,3,19,16,40,43,3
Bayer Leverkusen,Lukáš Hrádecký,fi FIN,GK,34.0,29.0,0,0,0,0,0,0,1,0.0,1,0,0,0,0,0,8,2
Bayer Leverkusen,Edmond Tapsoba,bf BFA,DF,25.0,27.9,39,24,19,16,4,22,39,56.4,17,21,14,7,24,63,89,3
Bayer Leverkusen,Piero Hincapié,ec ECU,DF,22.0,29.7,52,40,27,15,10,25,41,61.0,16,40,20,20,32,84,114,1
Bayer Leverkusen,Florian Wirtz,de GER,MF,21.0,26.2,32,20,10,12,10,9,22,40.9,13,32,3,29,10,42,6,1
Bayer Leverkusen,Jeremie Frimpong,nl NED,DF,23.0,25.9,33,25,14,12,7,16,29,55.2,13,25,0,25,8,41,22,1
Bayer Leverkusen,Patrik Schick,cz CZE,FW,28.0,18.8,6,5,1,3,2,1,5,20.0,4,9,1,8,4,10,17,1
Bayer Leverkusen,Robert Andrich,de GER,MF,29.0,17.9,24,12,8,14,2,7,14,50.0,7,16,8,8,29,53,23,0
Bayer Leverkusen,Aleix García,es ESP,MF,27.0,16.3,13,7,4,6,3,7,15,46.7,8,12,2,10,11,24,24,1
Bayer Leverkusen,Nathan Tella,ng NGA,MF,25.0,15.3,16,11,4,7,5,5,13,38.5,8,15,1,14,4,20,10,0
Bayer Leverkusen,Victor Boniface,ng NGA,FW,23.0,11.3,5,4,0,3,2,3,4,75.0,1,1,0,1,0,5,5,0
Bayer Leverkusen,Exequiel Palacios,ar ARG,MF,25.0,12.9,22,15,8,10,4,10,18,55.6,8,14,1,13,13,35,15,1
Bayer Leverkusen,Nordi Mukiele,fr FRA,DF,26.0,10.0,20,16,8,8,4,12,18,66.7,6,10,0,10,16,36,37,2
Bayer Leverkusen,Arthur,br BRA,DF,21.0,8.4,14,11,3,9,2,5,10,50.0,5,8,0,8,9,23,29,0
Bayer Leverkusen,Martin Terrier,fr FRA,MF,27.0,6.6,4,2,1,0,3,1,4,25.0,3,3,0,3,1,5,1,0
Bayer Leverkusen,Amine Adli,ma MAR,MF,24.0,8.6,15,9,4,2,9,4,11,36.4,7,11,0,11,0,15,4,0
Bayer Leverkusen,Matej Kovar,cz CZE,GK,24.0,5.0,0,0,0,0,0,0,0,,0,0,0,0,0,0,0,1
Bayer Leverkusen,Jonas Hofmann,de GER,MF,32.0,4.0,2,0,0,2,0,1,4,25.0,3,2,0,2,0,2,3,0
Bayer Leverkusen,Mario Hermoso,es ESP,DF,29.0,3.3,0,0,0,0,0,0,0,,0,3,1,2,9,9,15,1
Bayer Leverkusen,Emi Buendía,ar ARG,MF,27.0,2.9,6,5,1,4,1,5,8,62.5,3,6,0,6,0,6,0,0
Bayer Leverkusen,Jeanuël Belocian,fr FRA,DF,19.0,0.8,1,1,1,0,0,1,1,100.0,0,0,0,0,0,1,2,0
Eintracht Frankfurt,Arthur Theate,be BEL,DF,24.0,30.1,36,25,19,16,1,22,44,50.0,22,42,19,23,39,75,170,3
Eintracht Frankfurt,Hugo Ekitike,fr FRA,FW,22.0,28.7,16,12,3,8,5,4,12,33.3,8,13,1,12,7,23,24,0
Eintracht Frankfurt,Robin Koch,de GER,DF,28.0,28.8,24,11,14,8,2,10,22,45.5,12,39,25,14,25,49,197,4
Eintracht Frankfurt,Rasmus Kristensen,dk DEN,DF,27.0,28.0,59,33,37,17,5,40,67,59.7,27,50,13,37,20,79,97,1
Eintracht Frankfurt,Hugo Larsson,se SWE,MF,20.0,26.7,47,27,17,25,5,21,42,50.0,21,42,11,31,30,77,35,1
Eintracht Frankfurt,Kevin Trapp,de GER,GK,34.0,25.5,0,0,0,0,0,0,0,,0,0,0,0,0,0,13,3
Eintracht Frankfurt,Tuta,br BRA,DF,25.0,25.3,44,27,25,17,2,28,40,70.0,12,42,21,21,40,84,135,1
Eintracht Frankfurt,Ellyes Skhiri,tn TUN,MF,29.0,24.9,40,22,15,21,4,18,44,40.9,26,30,7,23,31,71,45,4
Eintracht Frankfurt,Nathaniel Brown,de GER,DF,21.0,21.7,71,42,39,18,14,44,55,80.0,11,30,0,30,15,86,55,1
Eintracht Frankfurt,Ansgar Knauff,de GER,MF,22.0,17.9,41,22,18,16,7,12,26,46.2,14,23,4,19,12,53,24,0
Eintracht Frankfurt,Mario Götze,de GER,MF,32.0,17.3,41,28,18,20,3,15,36,41.7,21,15,1,14,7,48,8,0
Eintracht Frankfurt,Omar Marmoush,eg EGY,FW,25.0,16.2,12,8,0,3,9,3,7,42.9,4,7,1,6,2,14,2,0
Eintracht Frankfurt,Nnamdi Collins,de GER,DF,20.0,16.6,33,24,24,7,2,17,22,77.3,5,22,11,11,16,49,74,3
Eintracht Frankfurt,Fares Chaïbi,dz ALG,MF,21.0,11.3,13,9,4,5,4,7,20,35.0,13,10,0,10,10,23,32,1
Eintracht Frankfurt,Jean Mattéo Bahoya,fr FRA,MF,19.0,10.3,29,18,11,13,5,16,26,61.5,10,14,2,12,4,33,10,1
Eintracht Frankfurt,Kauã Santos,br BRA,GK,21.0,8.5,0,0,0,0,0,0,0,,0,0,0,0,0,0,10,2
Eintracht Frankfurt,Oscar Højlund,dk DEN,MF,19.0,8.1,21,12,8,9,4,8,16,50.0,8,15,7,8,5,26,11,1
Eintracht Frankfurt,Can Uzun,tr TUR,MF,18.0,7.6,10,4,1,4,5,5,10,50.0,5,9,0,9,1,11,3,0
Eintracht Frankfurt,Niels Nkounkou,fr FRA,DF,23.0,4.3,13,10,7,3,3,4,7,57.1,3,5,2,3,7,20,15,0
Eintracht Frankfurt,Mahmoud Dahoud,de GER,MF,28.0,4.1,9,4,4,5,0,4,6,66.7,2,5,1,4,2,11,5,0
Eintracht Frankfurt,Michy Batshuayi,be BEL,FW,30.0,3.4,1,1,1,0,0,1,1,100.0,0,2,0,2,1,2,0,0
Eintracht Frankfurt,Junior Dina Ebimbe,fr FRA,MF,23.0,3.3,3,2,1,2,0,1,3,33.3,2,4,0,4,7,10,6,0
Eintracht Frankfurt,Igor Matanovic,hr CRO,FW,21.0,3.5,2,0,0,2,0,0,1,0.0,1,3,0,3,1,3,9,0
Eintracht Frankfurt,Elye Wahi,fr FRA,FW,21.0,2.2,0,0,0,0,0,0,1,0.0,1,1,0,1,0,0,1,0
Eintracht Frankfurt,Aurele Amenda,ch SUI,DF,21.0,1.1,1,0,1,0,0,0,0,,0,2,2,0,2,3,11,0
Eintracht Frankfurt,Timothy Chandler,us USA,DF,34.0,0.3,0,0,0,0,0,0,0,,0,0,0,0,3,3,2,0
Dortmund,Gregor Kobel,ch SUI,GK,26.0,32.0,0,0,0,0,0,0,0,,0,0,0,0,1,1,23,3
Dortmund,Serhou Guirassy,gn GUI,FW,28.0,28.9,7,6,2,2,3,2,5,40.0,3,10,3,7,4,11,38,0
Dortmund,Pascal Groß,de GER,MF,33.0,26.0,44,28,11,26,7,15,51,29.4,36,46,13,33,9,53,30,1
Dortmund,Julian Brandt,de GER,MF,28.0,25.8,26,11,13,8,5,15,43,34.9,28,17,0,17,14,40,13,1
Dortmund,Julian Ryerson,no NOR,DF,26.0,25.2,46,30,26,13,7,25,44,56.8,19,29,2,27,22,68,26,1
Dortmund,Emre Can,de GER,DF,30.0,23.4,50,28,30,16,4,18,36,50.0,18,31,17,14,20,70,89,3
Dortmund,Ramy Bensebaini,dz ALG,DF,29.0,22.5,51,25,25,18,8,33,51,64.7,18,42,9,33,33,84,86,1
Dortmund,Nico Schlotterbeck,de GER,DF,24.0,22.0,38,24,21,16,1,27,45,60.0,18,31,15,16,22,60,79,1
Dortmund,Waldemar Anton,de GER,DF,28.0,21.7,34,21,18,10,6,17,23,73.9,6,33,16,17,30,64,112,1
Dortmund,Jamie Gittens,eng ENG,FW,19.0,19.9,31,19,12,12,7,14,18,77.8,4,16,0,16,10,41,4,0
Dortmund,Felix Nmecha,de GER,MF,23.0,16.9,34,22,6,19,9,12,22,54.5,10,20,5,15,23,57,30,1
Dortmund,Marcel Sabitzer,at AUT,MF,30.0,18.0,29,19,7,15,7,16,27,59.3,11,19,6,13,10,39,29,1
Dortmund,Maximilian Beier,de GER,FW,21.0,17.8,25,16,8,11,6,12,31,38.7,19,15,1,14,7,32,14,1
Dortmund,Karim Adeyemi,de GER,FW,22.0,16.1,20,14,6,6,8,8,20,40.0,12,14,1,13,7,27,5,0
Dortmund,Niklas Süle,de GER,DF,28.0,11.8,14,12,9,5,0,10,14,71.4,4,11,6,5,4,18,46,1
Dortmund,Yan Couto,br BRA,DF,22.0,10.0,24,16,17,2,5,14,25,56.0,11,12,1,11,10,34,32,2
Dortmund,Daniel Svensson,se SWE,DF,22.0,8.7,15,11,5,6,4,7,11,63.6,4,10,4,6,5,20,30,0
Dortmund,Donyell Malen,nl NED,FW,25.0,6.9,0,0,0,0,0,0,2,0.0,2,2,0,2,3,3,6,0
Dortmund,Salih Özcan,tr TUR,MF,26.0,4.4,11,7,6,4,1,7,13,53.8,6,7,0,7,11,22,10,0
Dortmund,Gio Reyna,us USA,MF,21.0,3.9,7,0,3,0,4,4,5,80.0,1,3,1,2,0,7,9,0
Dortmund,Julien Duranville,be BEL,FW,18.0,3.2,3,0,0,3,0,1,2,50.0,1,1,0,1,0,3,3,0
Dortmund,Alexander Meyer,de GER,GK,33.0,2.0,0,0,0,0,0,0,0,,0,0,0,0,0,0,0,0
Dortmund,Carney Chukwuemeka,eng ENG,MF,20.0,2.8,7,5,3,2,2,1,1,100.0,0,5,0,5,1,8,1,0
Dortmund,Almugera Kabar,de GER,DF,18.0,1.5,5,3,2,2,1,3,3,100.0,0,1,0,1,1,6,4,0
Dortmund,Yannik Lührs,de GER,DF,20.0,1.4,1,1,1,0,0,0,0,,0,0,0,0,2,3,4,0
Dortmund,Ayman Azhil,ma MAR,MF,23.0,0.3,1,1,1,0,0,0,0,,0,0,0,0,0,1,0,0
Dortmund,Cole Campbell,us USA,MF,18.0,0.2,0,0,0,0,0,0,0,,0,0,0,0,0,0,1,0
Dortmund,Kjell-Arik Wätjen,de GER,MF,18.0,0.2,0,0,0,0,0,0,0,,0,0,0,0,0,0,2,0
Freiburg,Ritsu Doan,jp JPN,FW,26.0,32.0,66,42,33,26,7,25,46,54.3,21,57,2,55,14,80,47,1
Freiburg,Maximilian Eggestein,de GER,MF,27.0,31.7,57,32,21,26,10,24,43,55.8,19,37,10,27,39,96,54,1
Freiburg,Philipp Lienhart,at AUT,DF,28.0,30.8,22,13,12,10,0,15,31,48.4,16,31,20,11,36,58,124,3
Freiburg,Vincenzo Grifo,it ITA,FW,31.0,27.3,30,22,12,13,5,15,34,44.1,19,24,2,22,9,39,23,2
Freiburg,Matthias Ginter,de GER,DF,30.0,28.5,30,17,15,11,4,15,28,53.6,13,35,23,12,19,49,146,5
Freiburg,Christian Günter,de GER,DF,31.0,25.8,23,21,12,8,3,16,29,55.2,13,24,10,14,8,31,50,1
Freiburg,Patrick Osterhage,de GER,MF,24.0,25.3,45,29,16,27,2,14,30,46.7,16,27,3,24,18,63,37,0
Freiburg,Noah Atubolu,de GER,GK,22.0,25.6,0,0,0,0,0,0,0,,0,0,0,0,0,0,13,4
Freiburg,Lukas Kübler,de GER,DF,31.0,20.6,40,21,17,20,3,27,48,56.3,21,32,13,19,53,93,61,3
Freiburg,Lucas Höler,de GER,FW,30.0,20.9,37,24,18,15,4,9,24,37.5,15,29,7,22,7,44,36,0
Freiburg,Junior Adamu,at AUT,FW,23.0,17.3,9,3,3,3,3,3,11,27.3,8,14,0,14,12,21,20,0
Freiburg,Max Rosenfelder,de GER,DF,21.0,13.9,27,17,17,10,0,14,19,73.7,5,17,9,8,7,34,65,0
Freiburg,Eren Dinkçi,de GER,MF,22.0,13.4,21,13,8,8,5,7,23,30.4,16,22,2,20,7,28,7,0
Freiburg,Merlin Röhl,de GER,MF,22.0,10.8,16,10,4,10,2,9,11,81.8,2,9,1,8,6,22,2,0
Freiburg,Kiliann Sildillia,fr FRA,DF,22.0,8.9,17,10,8,6,3,7,13,53.8,6,16,5,11,11,28,38,0
Freiburg,Florian Müller,de GER,GK,26.0,8.4,0,0,0,0,0,0,0,,0,0,0,0,0,0,3,0
Freiburg,Nicolas Höfler,de GER,MF,34.0,8.8,33,23,13,18,2,20,31,64.5,11,7,1,6,14,47,28,1
Freiburg,Jordy Makengo,fr FRA,DF,22.0,8.3,16,9,10,5,1,10,16,62.5,6,8,3,5,7,23,29,0
Freiburg,Michael Gregoritsch,at AUT,FW,30.0,7.1,4,2,1,0,3,1,5,20.0,4,2,1,1,1,5,10,0
Freiburg,Johan Manzambi,ch SUI,FW,18.0,3.8,8,2,1,3,4,1,4,25.0,3,6,0,6,4,12,7,0
Freiburg,Jan-Niklas Beste,de GER,FW,25.0,2.4,2,1,0,1,1,1,7,14.3,6,3,0,3,1,3,7,0
Freiburg,Florent Muslija,xk KVX,FW,26.0,1.9,5,4,3,1,1,2,2,100.0,0,0,0,0,1,6,1,0
Freiburg,Noah Weißhaupt,de GER,FW,22.0,0.9,0,0,0,0,0,0,1,0.0,1,0,0,0,0,0,1,0
Freiburg,Roland Sallai,hu HUN,FW,27.0,0.5,2,1,1,1,0,0,0,,0,0,0,0,1,3,0,0
Freiburg,Ifechukwu Ogbus,ch SUI,DF,18.0,0.2,1,1,0,0,1,0,1,0.0,1,0,0,0,1,2,2,0
Freiburg,Maximilian Philipp,de GER,MF,30.0,0.2,0,0,0,0,0,0,0,,0,0,0,0,0,0,0,0
Mainz 05,Kaishu Sano,jp JPN,MF,23.0,33.8,61,36,22,31,8,25,52,48.1,27,66,14,52,65,126,56,1
Mainz 05,Anthony Caci,fr FRA,DF,27.0,30.1,60,40,23,25,12,28,44,63.6,16,33,8,25,27,87,47,2
Mainz 05,Robin Zentner,de GER,GK,29.0,32.0,2,1,2,0,0,1,2,50.0,1,0,0,0,0,2,31,4
Mainz 05,Phillipp Mwene,at AUT,DF,30.0,29.1,51,29,23,22,6,19,46,41.3,27,27,6,21,24,75,51,1
Mainz 05,Lee Jae-sung,kr KOR,MF,31.0,29.6,42,21,16,19,7,15,39,38.5,24,39,3,36,35,77,38,0
Mainz 05,Nadiem Amiri,de GER,MF,27.0,27.6,50,23,13,28,9,19,46,41.3,27,19,4,15,16,66,30,2
Mainz 05,Dominik Kohr,de GER,DF,30.0,25.6,62,46,34,21,7,35,55,63.6,20,43,24,19,42,104,127,0
Mainz 05,Jonathan Burkardt,de GER,FW,24.0,23.6,15,8,1,7,7,6,10,60.0,4,11,1,10,1,16,14,0
Mainz 05,Paul Nebel,de GER,MF,21.0,26.1,38,24,11,18,9,11,35,31.4,24,54,4,50,13,51,30,2
Mainz 05,Danny da Costa,de GER,DF,31.0,22.4,42,23,23,15,4,17,27,63.0,10,19,10,9,27,69,95,3
Mainz 05,Moritz Jenz,de GER,DF,25.0,17.8,36,20,18,18,0,16,21,76.2,5,23,14,9,30,66,128,2
Mainz 05,Stefan Bell,de GER,DF,32.0,16.0,22,12,16,6,0,9,14,64.3,5,16,14,2,28,50,107,1
Mainz 05,Andreas Hanche-Olsen,no NOR,DF,27.0,14.3,21,13,12,8,1,9,12,75.0,3,25,18,7,12,33,85,2
Mainz 05,Nelson Weiper,de GER,FW,19.0,7.9,5,4,2,3,0,2,4,50.0,2,5,0,5,2,7,5,1
Mainz 05,Maxim Leitsch,de GER,DF,26.0,7.5,12,4,6,4,2,7,9,77.8,2,12,4,8,10,22,42,1
Mainz 05,Armindo Sieb,de GER,FW,21.0,8.5,10,4,4,5,1,3,10,30.0,7,4,0,4,1,11,7,0
Mainz 05,Hong Hyunseok,kr KOR,MF,25.0,5.9,8,3,3,3,2,1,4,25.0,3,7,1,6,7,15,9,0
Mainz 05,Silvan Widmer,ch SUI,DF,31.0,5.6,11,5,3,6,2,8,12,66.7,4,7,1,6,5,16,27,0
Mainz 05,Nikolas Veratschnig,at AUT,DF,21.0,4.1,9,6,1,4,4,2,3,66.7,1,4,0,4,5,14,8,0
Mainz 05,Lasse Rieß,de GER,GK,23.0,2.0,0,0,0,0,0,0,0,,0,0,0,0,0,0,5,0
Mainz 05,Karim Onisiwo,at AUT,MF,32.0,1.2,1,1,0,0,1,0,0,,0,0,0,0,0,1,0,0
Mainz 05,Arnaud Nordin,fr FRA,DF,26.0,0.9,2,0,0,2,0,1,1,100.0,0,2,1,1,0,2,2,0
Mainz 05,Aymen Barkok,ma MAR,MF,26.0,0.8,2,1,1,1,0,1,1,100.0,0,1,1,0,2,4,0,0
Mainz 05,Lennard Maloney,us USA,MF,24.0,0.3,2,1,0,1,1,1,1,100.0,0,2,0,2,0,2,3,0
Mainz 05,Gabriel Vidovic,hr CRO,MF,20.0,0.0,0,0,0,0,0,0,0,,0,0,0,0,0,0,0,0
RB Leipzig,Péter Gulácsi,hu HUN,GK,34.0,29.2,1,1,1,0,0,1,2,50.0,1,0,0,0,0,1,16,4
RB Leipzig,Benjamin Šeško,si SVN,FW,21.0,26.7,7,3,0,4,3,3,11,27.3,8,15,4,11,5,12,20,0
RB Leipzig,Loïs Openda,be BEL,FW,24.0,27.4,9,4,3,4,2,3,11,27.3,8,19,1,18,5,14,12,0
RB Leipzig,Willi Orban,hu HUN,DF,31.0,24.7,38,21,23,14,1,23,32,71.9,9,45,31,14,21,59,169,4
RB Leipzig,Xavi Simons,nl NED,MF,21.0,24.0,28,21,5,15,8,12,26,46.2,14,19,3,16,12,40,19,1
RB Leipzig,David Raum,de GER,DF,26.0,19.9,38,28,16,14,8,20,35,57.1,15,25,8,17,9,47,47,4
RB Leipzig,Nicolas Seiwald,at AUT,MF,23.0,23.2,53,31,19,29,5,25,50,50.0,25,43,10,33,31,84,76,2
RB Leipzig,Lukas Klostermann,de GER,DF,28.0,20.5,27,14,18,7,2,14,24,58.3,10,31,17,14,24,51,143,3
RB Leipzig,Christoph Baumgartner,at AUT,MF,24.0,18.0,44,28,13,19,12,17,42,40.5,25,45,9,36,12,56,24,2
RB Leipzig,Kevin Kampl,si SVN,MF,33.0,17.8,27,18,11,10,6,16,26,61.5,10,25,6,19,24,51,25,0
RB Leipzig,Arthur Vermeeren,be BEL,MF,19.0,17.6,32,19,14,13,5,14,47,29.8,33,34,12,22,23,55,25,2
RB Leipzig,Castello Lukeba,fr FRA,DF,21.0,17.6,31,17,15,12,4,17,24,70.8,7,29,12,17,17,48,74,0
RB Leipzig,Lutsharel Geertruida,nl NED,DF,24.0,17.4,35,24,24,11,0,15,31,48.4,16,15,4,11,16,51,59,4
RB Leipzig,Antonio Nusa,no NOR,MF,19.0,17.4,30,17,16,9,5,18,36,50.0,18,22,2,20,8,38,11,0
RB Leipzig,Amadou Haidara,ml MLI,MF,26.0,14.8,30,17,12,16,2,12,29,41.4,17,42,12,30,18,48,56,1
RB Leipzig,Ridle Baku,de GER,DF,26.0,14.2,24,19,9,13,2,9,23,39.1,14,18,2,16,9,33,45,0
RB Leipzig,El Chadaille Bitshiabu,fr FRA,DF,19.0,12.6,27,18,17,9,1,10,19,52.6,9,25,14,11,13,40,97,2
RB Leipzig,Benjamin Henrichs,de GER,DF,27.0,10.4,32,16,18,10,4,14,27,51.9,13,22,3,19,15,47,33,0
RB Leipzig,Kosta Nedeljković,rs SRB,DF,18.0,5.4,11,8,5,6,0,6,10,60.0,4,6,4,2,2,13,14,0
RB Leipzig,Maarten Vandevoordt,be BEL,GK,22.0,4.8,1,0,1,0,0,1,1,100.0,0,0,0,0,0,1,4,0
RB Leipzig,Yussuf Poulsen,dk DEN,FW,30.0,4.2,10,5,2,6,2,4,8,50.0,4,7,2,5,0,10,14,0
RB Leipzig,Xaver Schlager,at AUT,MF,26.0,2.0,4,2,2,1,1,3,7,42.9,4,7,0,7,0,4,3,0
RB Leipzig,Tidiam Gomis,fr FRA,MF,17.0,1.7,0,0,0,0,0,0,0,,0,2,0,2,1,1,0,0
RB Leipzig,Mohamed Simakan,fr FRA,DF,24.0,0.6,0,0,0,0,0,0,0,,0,0,0,0,2,2,0,0
RB Leipzig,André Silva,pt POR,FW,28.0,1.5,1,1,1,0,0,0,1,0.0,1,1,0,1,1,2,2,0
RB Leipzig,Assan Ouedraogo,de GER,MF,18.0,0.6,0,0,0,0,0,0,0,,0,1,0,1,0,0,0,0
RB Leipzig,Elif Elmas,mk MKD,MF,24.0,0.5,3,1,3,0,0,1,3,33.3,2,2,0,2,0,3,2,0
RB Leipzig,Viggo Gebel,de GER,MF,16.0,0.2,0,0,0,0,0,0,0,,0,0,0,0,0,0,0,0
RB Leipzig,Faik Sakar,de GER,MF,16.0,0.0,0,0,0,0,0,0,0,,0,0,0,0,0,0,0,0
Werder Bremen,Michael Zetterer,de GER,GK,29.0,34.0,0,0,0,0,0,0,1,0.0,1,1,0,1,1,1,10,7
Werder Bremen,Mitchell Weiser,de GER,DF,30.0,31.9,61,40,19,34,8,28,56,50.0,28,33,3,30,22,83,61,3
Werder Bremen,Romano Schmid,at AUT,MF,24.0,31.6,43,25,10,22,11,24,51,47.1,27,42,3,39,11,54,9,2
Werder Bremen,Senne Lynen,be BEL,MF,25.0,30.5,72,39,36,30,6,39,69,56.5,30,56,13,43,65,137,75,5
Werder Bremen,Marvin Ducksch,de GER,FW,30.0,27.1,10,7,3,5,2,3,14,21.4,11,10,2,8,8,18,26,3
Werder Bremen,Jens Stage,dk DEN,MF,27.0,24.6,49,30,22,24,3,25,46,54.3,21,44,10,34,18,67,42,2
Werder Bremen,Marco Friedl,at AUT,DF,26.0,24.0,62,42,35,26,1,38,66,57.6,28,41,24,17,34,96,130,1
Werder Bremen,Niklas Stark,de GER,DF,29.0,23.5,33,21,20,11,2,14,21,66.7,7,41,27,14,36,69,129,1
Werder Bremen,Felix Agu,ng NGA,DF,24.0,19.6,30,14,12,14,4,12,23,52.2,11,27,9,18,21,51,48,0
Werder Bremen,Anthony Jung,de GER,DF,32.0,21.1,34,22,22,11,1,22,34,64.7,12,23,14,9,25,59,77,1
Werder Bremen,Amos Pieper,de GER,DF,26.0,16.7,32,17,16,11,5,21,33,63.6,12,28,17,11,24,56,98,1
Werder Bremen,Derrick Köhn,de GER,DF,25.0,15.1,20,10,7,10,3,10,14,71.4,4,21,4,17,10,30,26,0
Werder Bremen,Marco Grüll,at AUT,FW,26.0,13.2,12,9,1,5,6,4,17,23.5,13,14,2,12,3,15,10,0
Werder Bremen,Miloš Veljković,rs SRB,DF,28.0,11.4,10,5,6,3,1,7,15,46.7,8,14,9,5,2,12,47,1
Werder Bremen,Leonardo Bittencourt,de GER,MF,30.0,11.0,25,9,15,7,3,6,18,33.3,12,8,0,8,15,40,11,0
Werder Bremen,Justin Njinmah,de GER,FW,23.0,10.7,6,2,1,4,1,3,5,60.0,2,5,0,5,3,9,1,0
Werder Bremen,Oliver Burke,sct SCO,FW,27.0,10.2,11,4,5,1,5,4,6,66.7,2,20,0,20,2,13,6,0
Werder Bremen,Julián Malatini,ar ARG,DF,23.0,5.1,11,9,5,5,1,5,11,45.5,6,8,3,5,7,18,17,0
Werder Bremen,André Silva,pt POR,FW,28.0,4.2,2,2,1,1,0,0,1,0.0,1,3,1,2,0,2,3,0
Werder Bremen,Issa Kaboré,bf BFA,DF,23.0,3.4,8,4,2,5,1,4,6,66.7,2,8,2,6,2,10,7,0
Werder Bremen,Keke Maximilian Topp,de GER,FW,20.0,2.8,3,1,0,2,1,1,2,50.0,1,0,0,0,1,4,4,0
Werder Bremen,Skelly Alvero,fr FRA,MF,22.0,2.6,11,6,5,5,1,4,5,80.0,1,4,0,4,2,13,10,0
Werder Bremen,Olivier Deman,be BEL,DF,24.0,0.7,6,3,2,4,0,2,7,28.6,5,3,1,2,3,9,4,0
Stuttgart,Alexander Nübel,de GER,GK,27.0,34.0,0,0,0,0,0,0,1,0.0,1,0,0,0,0,0,18,3
Stuttgart,Angelo Stiller,de GER,MF,23.0,30.5,49,27,18,25,6,14,30,46.7,16,29,9,20,26,75,50,4
Stuttgart,Atakan Karazor,,MF,27.0,29.2,59,29,19,28,12,29,57,50.9,28,39,7,32,32,91,51,1
Stuttgart,Maximilian Mittelstädt,de GER,DF,27.0,27.5,79,54,42,30,7,53,73,72.6,20,47,11,36,47,126,96,2
Stuttgart,Julian Chabot,de GER,DF,26.0,25.3,37,24,19,15,3,15,32,46.9,17,29,19,10,38,75,135,0
Stuttgart,Chris Führich,de GER,MF,26.0,22.2,15,10,5,5,5,13,27,48.1,14,23,2,21,6,21,19,0
Stuttgart,Enzo Millot,fr FRA,MF,22.0,20.6,30,13,10,15,5,12,35,34.3,23,27,0,27,13,43,6,1
Stuttgart,Jamie Leweling,de GER,MF,23.0,18.7,16,6,6,3,7,11,25,44.0,14,22,1,21,11,27,17,1
Stuttgart,Ermedin Demirović,ba BIH,FW,26.0,20.8,12,7,3,4,5,3,12,25.0,9,14,3,11,3,15,12,0
Stuttgart,Deniz Undav,de GER,FW,28.0,19.3,11,10,2,3,6,1,17,5.9,16,15,2,13,3,14,10,0
Stuttgart,Josha Vagnoman,de GER,DF,23.0,20.5,26,14,11,13,2,17,34,50.0,17,16,2,14,14,40,57,1
Stuttgart,Nick Woltemade,de GER,FW,22.0,18.1,10,7,2,4,4,6,10,60.0,4,23,2,21,1,11,15,1
Stuttgart,Anthony Rouault,fr FRA,DF,23.0,13.5,15,11,10,3,2,10,15,66.7,5,18,9,9,19,34,63,1
Stuttgart,Leonidas Stergiou,ch SUI,DF,22.0,9.5,24,13,9,11,4,16,19,84.2,3,16,5,11,14,38,39,0
Stuttgart,Ramon Hendriks,nl NED,DF,23.0,12.8,20,9,11,7,2,9,13,69.2,4,15,7,8,19,39,63,0
Stuttgart,Finn Jeltsch,de GER,DF,18.0,8.7,18,13,6,11,1,12,15,80.0,3,12,6,6,13,31,27,2
Stuttgart,Fabian Rieder,ch SUI,MF,22.0,9.7,17,14,4,9,4,7,23,30.4,16,10,1,9,10,27,7,1
Stuttgart,Anrie Chase,jp JPN,DF,20.0,8.2,10,4,6,4,0,5,7,71.4,2,10,6,4,9,19,35,0
Stuttgart,Ameen Al-Dakhil,be BEL,DF,22.0,4.8,6,6,4,2,0,4,4,100.0,0,12,8,4,9,15,30,1
Stuttgart,Pascal Stenzel,de GER,DF,28.0,3.3,3,2,1,0,2,2,5,40.0,3,5,1,4,2,5,6,0
Stuttgart,Jacob Bruun Larsen,dk DEN,MF,25.0,4.6,1,1,1,0,0,0,2,0.0,2,7,0,7,1,2,4,1
Stuttgart,El Bilal Touré,ml MLI,FW,22.0,4.0,4,1,1,1,2,3,3,100.0,0,1,0,1,0,4,1,0
Stuttgart,Yannik Keitel,de GER,MF,24.0,3.0,9,6,3,5,1,9,10,90.0,1,5,2,3,4,13,6,0
Stuttgart,Luca Jaquez,ch SUI,DF,21.0,2.8,3,0,3,0,0,1,3,33.3,2,2,0,2,3,6,4,0
Stuttgart,Frans Krätzig,de GER,DF,21.0,0.6,2,1,1,0,1,1,3,33.3,2,2,1,1,0,2,1,0
Stuttgart,Justin Diehl,de GER,"FW,DF",19.0,1.2,1,0,0,1,0,1,1,100.0,0,2,0,2,0,1,0,0
Stuttgart,Dan-Axel Zagadou,fr FRA,DF,25.0,0.3,0,0,0,0,0,0,0,,0,0,0,0,1,1,1,0
Stuttgart,Nikolas Nartey,dk DEN,MF,24.0,0.2,0,0,0,0,0,0,0,,0,0,0,0,0,0,4,0
Stuttgart,Jarzinho Malanga,de GER,DF,18.0,0.0,0,0,0,0,0,0,0,,0,0,0,0,0,0,0,0
Monchengladbach,Julian Weigl,de GER,MF,28.0,32.1,53,25,24,24,5,28,46,60.9,18,54,27,27,48,101,86,3
Monchengladbach,Ko Itakura,jp JPN,DF,27.0,31.0,40,29,23,16,1,21,34,61.8,13,41,22,19,28,68,171,0
Monchengladbach,Tim Kleindienst,de GER,FW,28.0,30.5,30,15,6,15,9,10,35,28.6,25,45,9,36,12,42,66,1
Monchengladbach,Joe Scally,us USA,DF,21.0,28.8,45,32,25,18,2,27,46,58.7,19,35,11,24,16,61,86,2
Monchengladbach,Robin Hack,de GER,FW,25.0,24.4,22,17,11,8,3,12,28,42.9,16,30,2,28,9,31,28,0
Monchengladbach,Nico Elvedi,ch SUI,DF,27.0,23.7,38,23,28,6,4,17,23,73.9,6,35,27,8,30,68,163,0
Monchengladbach,Lukas Ullrich,de GER,DF,20.0,21.3,25,16,18,6,1,15,42,35.7,27,26,9,17,23,48,74,1
Monchengladbach,Alassane Pléa,fr FRA,MF,31.0,21.3,7,3,0,2,5,4,13,30.8,9,11,0,11,2,9,7,1
Monchengladbach,Rocco Reitz,de GER,MF,22.0,20.5,52,24,24,24,4,24,43,55.8,19,39,16,23,53,105,59,2
Monchengladbach,Moritz Nicolas,de GER,GK,26.0,18.2,0,0,0,0,0,0,0,,0,1,0,1,1,1,8,1
Monchengladbach,Franck Honorat,fr FRA,FW,27.0,16.2,17,7,10,4,3,2,8,25.0,6,9,1,8,5,22,28,1
Monchengladbach,Kevin Stöger,at AUT,MF,30.0,17.3,37,21,23,10,4,16,39,41.0,23,24,3,21,16,53,26,3
Monchengladbach,Philipp Sander,de GER,MF,26.0,15.7,33,17,16,15,2,10,23,43.5,13,16,7,9,23,56,44,3
Monchengladbach,Jonas Omlin,ch SUI,GK,30.0,10.9,0,0,0,0,0,0,1,0.0,1,0,0,0,0,0,5,1
Monchengladbach,Marvin Friedrich,de GER,DF,28.0,11.0,15,9,12,3,0,9,16,56.3,7,16,12,4,5,20,57,0
Monchengladbach,Nathan N'Goumou,cm CMR,FW,24.0,9.3,17,11,11,4,2,6,11,54.5,5,8,2,6,4,21,16,0
Monchengladbach,Luca Netz,de GER,DF,21.0,10.8,24,14,14,8,2,13,19,68.4,6,17,4,13,10,34,36,0
Monchengladbach,Tomáš Čvančara,cz CZE,FW,23.0,9.3,4,1,3,1,0,2,7,28.6,5,6,3,3,5,9,17,0
Monchengladbach,Stefan Lainer,at AUT,DF,31.0,8.4,22,13,16,5,1,12,14,85.7,2,12,6,6,12,34,30,0
Monchengladbach,Tiago Cardoso,lu LUX,GK,18.0,4.2,1,0,1,0,0,1,1,100.0,0,0,0,0,0,1,2,2
Monchengladbach,Fabio Chiarodia,it ITA,DF,19.0,4.2,10,4,6,4,0,4,6,66.7,2,8,3,5,9,19,53,1
Monchengladbach,Florian Neuhaus,de GER,MF,27.0,4.3,10,3,7,3,0,7,17,41.2,10,9,2,7,6,16,5,1
Monchengladbach,Shiō Fukuda,jp JPN,FW,20.0,0.7,0,0,0,0,0,0,0,,0,1,0,1,0,0,0,0
Monchengladbach,Tobias Sippel,de GER,GK,36.0,0.7,0,0,0,0,0,0,0,,0,0,0,0,0,0,0,0
Monchengladbach,Grant Ranos,am ARM,FW,21.0,0.2,1,0,0,1,0,0,1,0.0,1,2,0,2,0,1,0,0
Monchengladbach,Noah Pesch,hr CRO,FW,19.0,0.1,1,0,0,0,1,0,0,,0,0,0,0,0,1,0,0
Wolfsburg,Kamil Grabara,pl POL,GK,25.0,28.7,0,0,0,0,0,0,2,0.0,2,1,0,1,0,0,16,2
Wolfsburg,Mohamed Amoura,dz ALG,FW,24.0,27.6,29,22,14,5,10,14,37,37.8,23,42,2,40,9,38,24,0
Wolfsburg,Kilian Fischer,de GER,DF,23.0,25.7,64,44,48,12,4,47,89,52.8,42,41,8,33,19,83,98,2
Wolfsburg,Konstantinos Koulierakis,gr GRE,DF,20.0,27.5,40,20,25,13,2,25,40,62.5,15,34,14,20,33,73,147,2
Wolfsburg,Denis Vavro,sk SVK,DF,28.0,27.4,21,13,16,5,0,11,23,47.8,12,48,32,16,37,58,234,3
Wolfsburg,Maximilian Arnold,de GER,MF,30.0,26.2,34,20,13,18,3,15,33,45.5,18,21,11,10,24,58,70,2
Wolfsburg,Joakim Mæhle,dk DEN,DF,27.0,24.4,34,15,26,6,2,17,45,37.8,28,24,3,21,25,59,57,2
Wolfsburg,Tiago Tomás,pt POR,FW,22.0,21.1,33,19,15,11,7,15,35,42.9,20,17,4,13,9,42,19,0
Wolfsburg,Patrick Wimmer,at AUT,MF,23.0,19.9,47,35,19,21,7,15,46,32.6,31,31,4,27,32,79,15,2
Wolfsburg,Jonas Wind,dk DEN,FW,25.0,22.0,10,6,1,8,1,4,8,50.0,4,17,3,14,6,16,15,0
Wolfsburg,Bence Dárdai,hu HUN,MF,18.0,14.6,24,14,9,13,2,16,30,53.3,14,20,4,16,12,36,28,1
Wolfsburg,Yannick Gerhardt,de GER,MF,30.0,16.9,28,16,13,14,1,11,30,36.7,19,32,8,24,17,45,47,0
Wolfsburg,Mattias Svanberg,se SWE,MF,25.0,13.6,20,10,6,11,3,9,19,47.4,10,11,4,7,15,35,26,0
Wolfsburg,Ridle Baku,de GER,FW,26.0,13.1,23,15,9,9,5,8,19,42.1,11,22,1,21,15,38,15,0
Wolfsburg,Jakub Kamiński,pl POL,DF,22.0,12.6,17,8,8,3,6,9,22,40.9,13,17,7,10,13,30,23,1
Wolfsburg,Sebastiaan Bornauw,be BEL,DF,25.0,8.8,9,6,4,4,1,4,8,50.0,4,14,12,2,12,21,36,0
Wolfsburg,Aster Vranckx,be BEL,MF,21.0,6.2,11,6,3,8,0,3,9,33.3,6,14,3,11,10,21,13,0
Wolfsburg,Cedric Zesiger,ch SUI,DF,26.0,5.8,13,8,6,5,2,6,12,50.0,6,6,5,1,3,16,28,0
Wolfsburg,Marius Müller,de GER,GK,31.0,5.3,0,0,0,0,0,0,0,,0,0,0,0,0,0,0,0
Wolfsburg,Andreas Skov Olsen,dk DEN,FW,24.0,6.0,8,6,5,3,0,4,4,100.0,0,4,0,4,2,10,12,0
Wolfsburg,Lukas Nmecha,de GER,FW,25.0,5.2,2,0,1,1,0,0,1,0.0,1,3,0,3,2,4,4,0
Wolfsburg,Salih Özcan,tr TUR,MF,26.0,3.9,2,2,1,0,1,1,5,20.0,4,5,1,4,7,9,5,0
Wolfsburg,Lovro Majer,hr CRO,MF,26.0,3.4,2,1,0,1,1,1,5,20.0,4,5,1,4,1,3,2,1
Wolfsburg,Mads Roerslev,dk DEN,DF,25.0,3.3,10,9,8,1,1,6,9,66.7,3,2,2,0,5,15,16,0
Wolfsburg,David Odogu,de GER,DF,18.0,2.2,6,4,4,2,0,3,5,60.0,2,2,2,0,2,8,25,1
Wolfsburg,Kevin Paredes,us USA,DF,21.0,1.4,3,1,3,0,0,2,3,66.7,1,2,2,0,1,4,0,0
Wolfsburg,Kevin Behrens,de GER,FW,33.0,1.9,1,1,0,1,0,0,1,0.0,1,0,0,0,1,2,2,0
Augsburg,Jeffrey Gouweleeuw,nl NED,DF,33.0,32.7,50,28,25,21,4,27,40,67.5,13,34,15,19,35,85,183,0
Augsburg,Dimitris Giannoulis,gr GRE,DF,28.0,29.5,47,32,27,16,4,26,44,59.1,18,49,11,38,47,94,75,0
Augsburg,Frank Onyeka,ng NGA,MF,26.0,28.9,58,45,22,28,8,22,40,55.0,18,36,9,27,36,94,36,2
Augsburg,Chrislain Matsima,fr FRA,DF,22.0,28.4,31,20,19,11,1,17,26,65.4,9,48,29,19,52,83,163,0
Augsburg,Marius Wolf,de GER,DF,29.0,24.1,27,16,13,11,3,16,43,37.2,27,29,5,24,24,51,51,1
Augsburg,Kristijan Jakić,hr CRO,MF,27.0,25.7,46,23,20,19,7,22,43,51.2,21,42,9,33,28,74,50,1
Augsburg,Alexis Claude-Maurice,fr FRA,MF,26.0,23.6,41,26,12,15,14,17,34,50.0,17,16,0,16,15,56,8,1
Augsburg,Elvis Rexhbeçaj,xk KVX,MF,26.0,20.0,27,19,9,14,4,15,35,42.9,20,40,9,31,16,43,22,1
Augsburg,Samuel Essende,cd COD,FW,26.0,18.4,7,6,1,3,3,3,4,75.0,1,13,2,11,0,7,11,1
Augsburg,Finn Dahmen,de GER,GK,26.0,19.0,1,0,1,0,0,1,2,50.0,1,0,0,0,0,1,9,0
Augsburg,Phillip Tietz,de GER,FW,27.0,18.9,11,6,2,7,2,5,8,62.5,3,10,1,9,5,16,26,1
Augsburg,Nediljko Labrović,hr CRO,GK,24.0,15.0,0,0,0,0,0,0,0,,0,0,0,0,0,0,12,1
Augsburg,Keven Schlotterbeck,de GER,DF,27.0,14.4,19,17,9,9,1,12,16,75.0,4,13,6,7,15,34,73,1
Augsburg,Cedric Zesiger,ch SUI,DF,26.0,13.6,13,7,7,6,0,8,13,61.5,5,17,10,7,21,34,96,1
Augsburg,Fredrik Jensen,fi FIN,MF,26.0,8.6,7,7,1,3,3,4,5,80.0,1,10,1,9,4,11,17,0
Augsburg,Maximilian Bauer,de GER,DF,24.0,7.3,14,8,5,7,2,9,14,64.3,5,10,4,6,6,20,35,1
Augsburg,Arne Maier,de GER,MF,25.0,10.5,13,7,4,8,1,7,13,53.8,6,15,1,14,6,19,14,1
Augsburg,Mert Kömür,de GER,MF,19.0,7.3,3,2,2,0,1,0,3,0.0,3,9,3,6,3,6,7,1
Augsburg,Henri Koudossou,de GER,DF,24.0,8.3,18,10,6,11,1,11,19,57.9,8,8,2,6,15,33,37,0
Augsburg,Ruben Vargas,ch SUI,MF,25.0,3.4,2,1,1,1,0,1,4,25.0,3,1,0,1,2,4,1,1
Augsburg,Noahkai Banks,us USA,DF,17.0,3.1,11,5,6,4,1,3,7,42.9,4,4,1,3,5,16,28,0
Augsburg,Robert Gumny,pl POL,DF,26.0,3.0,3,3,1,2,0,2,6,33.3,4,2,0,2,1,4,6,0
Augsburg,Mads Pedersen,dk DEN,DF,27.0,2.6,8,7,5,2,1,4,5,80.0,1,4,0,4,2,10,6,0
Augsburg,Tim Breithaupt,de GER,MF,22.0,1.4,1,1,0,1,0,0,4,0.0,4,1,0,1,2,3,0,0
Augsburg,Steve Mounié,bj BEN,FW,29.0,3.9,4,4,0,1,3,0,1,0.0,1,1,1,0,1,5,5,1
Augsburg,Arne Engels,be BEL,MF,20.0,0.9,0,0,0,0,0,0,0,,0,1,1,0,0,0,0,0
Augsburg,Yusuf Kabadayı,de GER,FW,20.0,0.8,1,0,0,1,0,0,0,,0,1,0,1,0,1,0,0
Augsburg,Mergim Berisha,de GER,FW,26.0,0.4,1,0,0,1,0,1,1,100.0,0,2,1,1,0,1,0,0
Augsburg,Niklas Dorsch,de GER,MF,26.0,0.4,0,0,0,0,0,0,0,,0,1,0,1,0,0,0,0
Union Berlin,Danilho Doekhi,nl NED,DF,26.0,34.0,37,24,18,16,3,13,23,56.5,10,35,16,19,44,81,169,1
Union Berlin,Rani Khedira,de GER,MF,30.0,30.3,68,40,30,35,3,24,38,63.2,14,33,11,22,44,112,55,0
Union Berlin,Benedict Hollerbach,de GER,FW,23.0,28.4,43,22,8,23,12,21,51,41.2,30,35,0,35,2,45,13,1
Union Berlin,Diogo Leite,pt POR,DF,25.0,28.3,64,32,43,17,4,33,50,66.0,17,61,25,36,57,121,162,1
Union Berlin,Frederik Rønnow,dk DEN,GK,31.0,28.0,0,0,0,0,0,0,1,0.0,1,0,0,0,0,0,22,2
Union Berlin,Janik Haberer,de GER,MF,30.0,19.0,39,29,16,21,2,26,44,59.1,18,16,0,16,17,56,37,0
Union Berlin,Christopher Trimmel,at AUT,DF,37.0,19.4,38,25,23,14,1,28,42,66.7,14,14,6,8,18,56,92,0
Union Berlin,Tom Rothe,de GER,DF,19.0,18.6,45,28,27,15,3,29,51,56.9,22,41,5,36,18,63,57,1
Union Berlin,Leopold Querfeld,at AUT,DF,20.0,19.4,25,12,21,4,0,13,18,72.2,5,25,10,15,19,44,144,2
Union Berlin,András Schäfer,hu HUN,MF,25.0,17.2,52,26,23,24,5,25,41,61.0,16,33,6,27,22,74,36,0
Union Berlin,Jeong Woo-yeong,kr KOR,MF,24.0,14.2,10,7,5,5,0,3,11,27.3,8,10,1,9,11,21,11,0
Union Berlin,Kevin Vogt,de GER,DF,32.0,15.2,12,8,7,5,0,8,13,61.5,5,16,8,8,9,21,75,1
Union Berlin,Josip Juranović,hr CRO,DF,28.0,12.9,21,13,12,6,3,10,25,40.0,15,13,6,7,7,28,42,2
Union Berlin,Tim Skarke,de GER,FW,27.0,13.0,14,11,5,8,1,10,19,52.6,9,7,0,7,5,19,17,0
Union Berlin,Andrej Ilic,rs SRB,FW,24.0,10.5,2,2,0,2,0,0,6,0.0,6,7,3,4,5,7,6,1
Union Berlin,Aljoscha Kemlein,de GER,MF,19.0,10.3,10,4,4,5,1,5,14,35.7,9,14,3,11,6,16,15,0
Union Berlin,Robert Skov,dk DEN,DF,28.0,9.6,15,11,8,7,0,10,20,50.0,10,8,1,7,8,23,9,0
Union Berlin,Jordan Pefok,us USA,FW,28.0,10.2,11,6,6,0,5,3,7,42.9,4,9,2,7,4,15,18,0
Union Berlin,Yorbe Vertessen,be BEL,MF,23.0,8.0,6,3,3,2,1,2,8,25.0,6,6,0,6,3,9,6,0
Union Berlin,Lucas Tousart,fr FRA,MF,27.0,6.3,17,9,6,9,2,5,12,41.7,7,11,4,7,7,24,27,0
Union Berlin,Alexander Schwolow,de GER,GK,32.0,6.0,0,0,0,0,0,0,0,,0,0,0,0,0,0,2,1
Union Berlin,László Bénes,sk SVK,MF,26.0,6.6,2,2,1,1,0,1,3,33.3,2,5,1,4,3,5,9,0
Union Berlin,Ivan Prtajin,hr CRO,FW,28.0,1.8,3,2,0,1,2,0,0,,0,2,0,2,0,3,3,0
Union Berlin,Marin Ljubicic,hr CRO,FW,22.0,3.1,2,1,0,2,0,1,3,33.3,2,2,0,2,0,2,7,0
Union Berlin,Jérôme Roussillon,fr FRA,DF,31.0,1.5,0,0,0,0,0,0,2,0.0,2,0,0,0,2,2,7,0
Union Berlin,David Preu,de GER,MF,19.0,1.4,1,1,0,1,0,0,2,0.0,2,4,2,2,0,1,2,0
Union Berlin,Robin Gosens,de GER,DF,30.0,1.0,0,0,0,0,0,0,3,0.0,3,1,0,1,1,1,2,0
Union Berlin,Kevin Volland,de GER,FW,32.0,0.7,0,0,0,0,0,0,0,,0,1,0,1,0,0,1,0
St Pauli,Hauke Wahl,de GER,DF,30.0,33.0,36,27,21,13,2,23,38,60.5,15,44,25,19,31,67,170,4
St Pauli,Nikola Vasilj,ba BIH,GK,28.0,33.0,0,0,0,0,0,0,2,0.0,2,0,0,0,0,0,22,3
St Pauli,Philipp Treu,de GER,MF,23.0,32.1,61,42,35,17,9,39,68,57.4,29,52,12,40,19,80,87,2
St Pauli,Eric Smith,se SWE,DF,27.0,31.4,46,29,26,17,3,23,40,57.5,17,37,10,27,37,83,104,4
St Pauli,Jackson Irvine,au AUS,MF,31.0,29.0,56,28,24,26,6,25,45,55.6,20,27,5,22,36,92,63,2
St Pauli,Manolis Saliakas,gr GRE,MF,27.0,25.8,46,22,24,18,4,25,49,51.0,24,38,8,30,20,66,62,0
St Pauli,David Nemeth,at AUT,DF,23.0,23.8,43,29,25,16,2,25,43,58.1,18,29,11,18,18,61,94,2
St Pauli,Johannes Eggestein,de GER,FW,26.0,20.8,5,3,0,2,3,1,5,20.0,4,5,0,5,0,5,8,0
St Pauli,Morgan Guilavogui,gn GUI,FW,26.0,20.2,32,17,11,16,5,14,31,45.2,17,28,0,28,13,45,33,0
St Pauli,Carlo Boukhalfa,ma MAR,MF,25.0,18.4,26,11,7,17,2,7,19,36.8,12,22,3,19,12,38,25,1
St Pauli,Oladapo Afolayan,eng ENG,FW,26.0,18.4,17,8,4,8,5,7,19,36.8,12,17,1,16,8,25,20,0
St Pauli,Danel Sinani,lu LUX,FW,27.0,14.0,14,11,2,7,5,6,14,42.9,8,12,1,11,1,15,13,0
St Pauli,Noah Weißhaupt,de GER,FW,22.0,13.0,6,4,3,0,3,3,8,37.5,5,7,0,7,2,8,8,1
St Pauli,Lars Ritzka,de GER,DF,26.0,10.3,49,29,28,16,5,25,41,61.0,16,16,2,14,11,60,41,0
St Pauli,Siebe Van Der Heyden,be BEL,DF,26.0,9.7,17,10,10,7,0,8,18,44.4,10,8,4,4,17,34,43,2
St Pauli,Elias Saad,tn TUN,FW,24.0,10.1,20,13,7,8,5,10,20,50.0,10,14,0,14,3,23,1,0
St Pauli,Karol Mets,ee EST,DF,31.0,10.0,13,8,6,7,0,4,7,57.1,3,9,3,6,12,25,60,0
St Pauli,James Sands,us USA,MF,24.0,5.0,15,6,5,8,2,4,4,100.0,0,5,1,4,5,20,8,0
St Pauli,Robert Wagner,de GER,MF,21.0,4.6,8,3,2,6,0,4,13,30.8,9,8,0,8,2,10,12,0
St Pauli,Connor Metcalfe,au AUS,MF,24.0,4.0,2,0,1,1,0,0,5,0.0,5,4,0,4,3,5,8,0
St Pauli,Adam Dźwigała,pl POL,DF,28.0,4.2,20,10,13,6,1,11,16,68.8,5,6,1,5,4,24,28,0
St Pauli,Ben Alexander Voll,de GER,GK,23.0,1.0,0,0,0,0,0,0,0,,0,0,0,0,0,0,0,0
St Pauli,Scott Banks,sct SCO,FW,22.0,1.3,1,1,1,0,0,0,2,0.0,2,0,0,0,2,3,2,0
St Pauli,Andreas Albers,dk DEN,FW,34.0,0.7,1,1,0,0,1,0,1,0.0,1,0,0,0,0,1,1,0
St Pauli,Abdoulie Ceesay,gm GAM,FW,20.0,0.7,3,3,1,1,1,2,3,66.7,1,2,0,2,0,3,1,0
St Pauli,Erik Ahlstrand,se SWE,FW,22.0,0.5,0,0,0,0,0,0,0,,0,1,0,1,1,1,1,0
St Pauli,Maurides,br BRA,FW,30.0,0.0,0,0,0,0,0,0,0,,0,0,0,0,0,0,0,0
St Pauli,Finley Stevens,wls WAL,DF,21.0,0.0,0,0,0,0,0,0,0,,0,0,0,0,0,0,0,0
Hoffenheim,Andrej Kramarić,hr CRO,MF,33.0,30.9,15,8,5,8,2,6,11,54.5,5,16,3,13,7,22,11,1
Hoffenheim,Tom Bischof,de GER,MF,19.0,28.6,95,53,36,45,14,40,77,51.9,37,66,11,55,30,125,53,1
Hoffenheim,Anton Stach,de GER,MF,25.0,28.8,66,46,25,37,4,32,47,68.1,15,47,13,34,46,112,101,2
Hoffenheim,Oliver Baumann,de GER,GK,34.0,28.0,2,2,2,0,0,2,4,50.0,2,0,0,0,0,2,15,2
Hoffenheim,Arthur Chaves,br BRA,DF,23.0,24.3,51,36,28,19,4,25,50,50.0,25,47,20,27,37,88,136,3
Hoffenheim,Kevin Akpoguma,ng NGA,DF,29.0,24.7,54,27,36,12,6,30,46,65.2,16,65,37,28,29,83,115,1
Hoffenheim,Adam Hložek,cz CZE,FW,22.0,20.9,22,10,7,8,7,11,20,55.0,9,13,1,12,4,26,20,0
Hoffenheim,Marius Bülter,de GER,"FW,DF",31.0,19.4,13,10,5,6,2,9,17,52.9,8,10,3,7,4,17,14,1
Hoffenheim,Alexander Prass,at AUT,DF,23.0,17.5,42,23,24,15,3,24,59,40.7,35,33,6,27,9,51,53,4
Hoffenheim,Pavel Kadeřábek,cz CZE,DF,32.0,17.6,25,14,14,4,7,15,31,48.4,16,13,3,10,20,45,54,1
Hoffenheim,Stanley N'Soki,fr FRA,DF,25.0,14.6,22,16,13,7,2,12,23,52.2,11,22,7,15,26,48,58,3
Hoffenheim,Valentin Gendrey,fr FRA,DF,24.0,15.8,30,12,19,9,2,11,18,61.1,7,19,5,14,15,45,53,0
Hoffenheim,Leo Skiri Østigård,no NOR,DF,24.0,10.3,9,7,5,4,0,4,6,66.7,2,17,9,8,9,18,111,0
Hoffenheim,Florian Grillitsch,at AUT,MF,28.0,6.7,15,9,5,9,1,8,14,57.1,6,6,2,4,8,23,18,0
Hoffenheim,Dennis Geiger,de GER,MF,26.0,8.2,24,11,9,13,2,12,19,63.2,7,15,2,13,7,31,6,1
Hoffenheim,Gift Orban,ng NGA,FW,22.0,7.7,3,1,2,1,0,1,6,16.7,5,7,0,7,0,3,3,0
Hoffenheim,Finn Ole Becker,de GER,MF,24.0,7.5,11,5,4,6,1,1,4,25.0,3,7,3,4,10,21,20,0
Hoffenheim,Bazoumana Touré,ci CIV,FW,18.0,6.8,12,10,2,7,3,2,8,25.0,6,4,0,4,3,15,2,0
Hoffenheim,Haris Tabakovic,ba BIH,FW,30.0,9.2,3,1,1,0,2,0,3,0.0,3,4,2,2,1,4,16,0
Hoffenheim,David Jurásek,cz CZE,DF,23.0,6.9,6,3,3,2,1,2,5,40.0,3,5,0,5,6,12,17,0
Hoffenheim,Luca Philipp,de GER,GK,23.0,6.0,1,0,1,0,0,1,1,100.0,0,0,0,0,0,1,1,0
Hoffenheim,Diadie Samassékou,ml MLI,MF,28.0,3.3,5,5,1,2,2,2,4,50.0,2,4,2,2,5,10,5,0
Hoffenheim,Max Moerstedt,de GER,FW,nan,5.1,5,5,1,3,1,1,2,50.0,1,4,0,4,0,5,5,0
Hoffenheim,Tim Drexler,de GER,DF,19.0,4.0,17,7,11,6,0,9,12,75.0,3,6,4,2,1,18,9,1
Hoffenheim,Jacob Bruun Larsen,dk DEN,FW,25.0,4.5,4,3,1,2,1,3,8,37.5,5,5,1,4,1,5,2,0
Hoffenheim,Umut Tohumcu,de GER,MF,19.0,4.2,9,5,3,5,1,5,7,71.4,2,5,0,5,3,12,6,0
Hoffenheim,Mergim Berisha,de GER,FW,26.0,3.7,3,3,1,2,0,0,3,0.0,3,2,1,1,0,3,3,0
Hoffenheim,Erencan Yardimci,tr TUR,FW,22.0,3.5,4,3,1,3,0,1,2,50.0,1,2,0,2,1,5,2,0
Hoffenheim,Robin Hranáč,cz CZE,DF,24.0,2.4,0,0,0,0,0,0,1,0.0,1,3,2,1,5,5,9,1
Hoffenheim,Grischa Prömel,de GER,MF,29.0,1.9,0,0,0,0,0,0,1,0.0,1,1,1,0,2,2,4,0
Hoffenheim,Florian Micheler,at AUT,MF,19.0,0.4,0,0,0,0,0,0,2,0.0,2,0,0,0,0,0,0,0
Hoffenheim,Hannes Behrens,de GER,DF,nan,0.3,1,1,0,1,0,0,0,,0,1,0,1,2,3,0,0
Hoffenheim,David Mokwa,fr FRA,DF,20.0,0.2,1,0,1,0,0,0,0,,0,0,0,0,0,1,0,0
Hoffenheim,Paul Hennrich,de GER,MF,19.0,0.1,0,0,0,0,0,0,0,,0,1,1,0,0,0,0,0
Hoffenheim,Ihlas Bebou,tg TOG,MF,30.0,0.1,0,0,0,0,0,0,0,,0,0,0,0,0,0,0,0
Heidenheim,Patrick Mainka,de GER,DF,29.0,34.0,58,30,36,20,2,35,55,63.6,20,61,36,25,68,126,206,0
Heidenheim,Kevin Müller,de GER,GK,33.0,32.7,3,2,3,0,0,3,3,100.0,0,0,0,0,0,3,13,4
Heidenheim,Jan Schöppner,de GER,MF,25.0,29.9,56,30,19,27,10,20,58,34.5,38,38,6,32,43,99,95,1
Heidenheim,Benedikt Gimber,de GER,DF,27.0,29.7,72,46,48,23,1,38,63,60.3,25,53,19,34,31,103,131,1
Heidenheim,Omar Traoré,de GER,DF,26.0,29.1,50,26,31,16,3,25,41,61.0,16,35,6,29,21,71,66,0
Heidenheim,Marvin Pieringer,de GER,FW,24.0,24.7,23,13,5,12,6,5,10,50.0,5,21,2,19,8,31,32,0
Heidenheim,Jonas Föhrenbach,de GER,DF,28.0,20.4,45,24,25,15,5,22,35,62.9,13,29,3,26,16,61,57,0
Heidenheim,Paul Wanner,de GER,MF,18.0,19.8,40,27,16,21,3,15,32,46.9,17,15,0,15,4,44,20,0
Heidenheim,Niklas Dorsch,de GER,MF,26.0,15.0,27,16,12,15,0,13,22,59.1,9,14,1,13,17,44,17,2
Heidenheim,Adrian Beck,de GER,MF,27.0,17.9,36,17,18,12,6,12,35,34.3,23,31,2,29,9,45,17,0
Heidenheim,Marnon Busch,de GER,DF,29.0,15.6,26,17,19,7,0,23,32,71.9,9,23,10,13,13,39,65,5
Heidenheim,Frans Krätzig,de GER,DF,21.0,13.6,32,18,14,12,6,12,21,57.1,9,12,1,11,17,49,15,0
Heidenheim,Tim Siersleben,de GER,DF,24.0,13.2,21,14,12,8,1,7,17,41.2,10,19,6,13,20,41,66,0
Heidenheim,Léo Scienza,br BRA,FW,25.0,12.9,17,12,10,5,2,7,18,38.9,11,13,1,12,5,22,9,1
Heidenheim,Mathias Honsak,at AUT,"FW,DF",27.0,13.2,15,8,10,5,0,10,23,43.5,13,19,4,15,10,25,31,0
Heidenheim,Budu Zivzivadze,ge GEO,FW,30.0,10.7,17,11,1,9,7,4,8,50.0,4,9,0,9,3,20,7,0
Heidenheim,Lennard Maloney,us USA,MF,24.0,8.5,20,11,12,7,1,14,23,60.9,9,9,2,7,14,34,38,0
Heidenheim,Luca Kerber,de GER,MF,22.0,8.8,26,16,17,8,1,16,31,51.6,15,14,4,10,5,31,25,1
Heidenheim,Sirlord Conteh,de GER,FW,28.0,9.9,9,5,3,6,0,2,7,28.6,5,1,1,0,1,10,8,0
Heidenheim,Mikkel Kaufmann,dk DEN,FW,23.0,4.2,6,4,1,3,2,2,5,40.0,3,5,2,3,2,8,7,0
Heidenheim,Maximilian Breunig,de GER,FW,23.0,3.9,4,3,1,2,1,3,6,50.0,3,9,2,7,1,5,3,0
Heidenheim,Thomas Keller,de GER,DF,24.0,1.7,6,5,5,1,0,4,6,66.7,2,3,1,2,4,10,11,0
Heidenheim,Frank Feller,de GER,GK,20.0,1.3,0,0,0,0,0,0,0,,0,0,0,0,0,0,1,0
Heidenheim,Stefan Schimmer,de GER,FW,30.0,2.7,2,0,1,1,0,1,2,50.0,1,1,0,1,0,2,4,0
Heidenheim,Julian Niehues,de GER,MF,23.0,1.7,3,1,3,0,0,1,5,20.0,4,1,0,1,0,3,8,0
Heidenheim,Norman Theuerkauf,de GER,MF,37.0,0.2,0,0,0,0,0,0,0,,0,0,0,0,0,0,0,0
Heidenheim,Denis Thomalla,de GER,MF,31.0,0.0,0,0,0,0,0,0,0,,0,0,0,0,0,0,0,0
Holstein Kiel,Timo Becker,de GER,DF,27.0,27.2,53,33,39,9,5,34,46,73.9,12,30,17,13,17,70,110,1
Holstein Kiel,Nicolai Remberg,de GER,MF,24.0,26.9,45,25,24,17,4,19,41,46.3,22,46,20,26,29,74,100,0
Holstein Kiel,Timon Weiner,de GER,GK,25.0,25.0,0,0,0,0,0,0,1,0.0,1,0,0,0,0,0,17,3
Holstein Kiel,Shuto Machino,jp JPN,FW,24.0,21.9,8,5,4,3,1,6,16,37.5,10,12,3,9,7,15,28,1
Holstein Kiel,Armin Gigovic,ba BIH,MF,22.0,21.3,25,13,14,8,3,5,21,23.8,16,20,1,19,21,46,33,0
Holstein Kiel,Magnus Knudsen,no NOR,MF,23.0,20.7,48,29,21,21,6,25,44,56.8,19,18,4,14,12,60,44,0
Holstein Kiel,Lasse Rosenboom,de GER,DF,22.0,19.3,47,35,25,16,6,32,47,68.1,15,28,9,19,19,66,71,3
Holstein Kiel,Finn Porath,de GER,DF,27.0,22.0,45,26,24,14,7,26,53,49.1,27,27,9,18,21,66,67,0
Holstein Kiel,Marko Ivezić,rs SRB,DF,22.0,18.4,29,19,20,6,3,15,42,35.7,27,25,13,12,27,56,103,2
Holstein Kiel,David Zec,si SVN,DF,24.0,17.2,23,10,17,6,0,13,20,65.0,7,32,18,14,17,40,93,3
Holstein Kiel,Phil Harres,de GER,FW,22.0,17.3,10,10,3,4,3,4,8,50.0,4,17,3,14,5,15,20,0
Holstein Kiel,Marco Komenda,hr CRO,DF,27.0,14.6,26,17,12,13,1,11,15,73.3,4,23,11,12,6,32,68,0
Holstein Kiel,Steven Skrzybski,de GER,MF,31.0,14.8,19,6,7,6,6,7,24,29.2,17,16,0,16,11,30,11,0
Holstein Kiel,Alexander Bernhardsson,se SWE,FW,25.0,14.2,29,15,9,9,11,20,31,64.5,11,14,0,14,5,34,25,0
Holstein Kiel,Max Geschwill,de GER,DF,23.0,14.3,26,21,13,12,1,14,19,73.7,5,14,9,5,30,56,53,1
Holstein Kiel,Lewis Holtby,de GER,MF,33.0,13.8,34,20,19,10,5,12,28,42.9,16,14,2,12,21,55,26,3
Holstein Kiel,Patrick Erras,de GER,DF,29.0,9.3,8,5,6,2,0,2,9,22.2,7,13,11,2,9,17,64,0
Holstein Kiel,Thomas Dähne,de GER,GK,30.0,9.0,0,0,0,0,0,0,0,,0,0,0,0,0,0,7,2
Holstein Kiel,John Tolkin,us USA,DF,22.0,8.2,18,11,11,7,0,12,14,85.7,2,10,2,8,8,26,54,0
Holstein Kiel,Benedikt Pichler,at AUT,FW,27.0,8.7,5,2,1,0,4,2,4,50.0,2,4,2,2,2,7,11,0
Holstein Kiel,Carl Johansson,se SWE,DF,30.0,6.3,4,2,4,0,0,3,7,42.9,4,12,8,4,10,14,54,1
Holstein Kiel,Tymoteusz Puchacz,pl POL,DF,25.0,4.4,9,4,6,3,0,5,7,71.4,2,4,1,3,3,12,11,0
Holstein Kiel,Dominik Javorček,sk SVK,DF,21.0,4.3,3,0,3,0,0,1,5,20.0,4,7,3,4,5,8,26,1
Holstein Kiel,Jann-Fiete Arp,de GER,FW,24.0,7.9,13,10,5,2,6,4,13,30.8,9,6,0,6,3,16,8,1
Holstein Kiel,Marvin Schulz,de GER,MF,29.0,3.4,6,5,2,2,2,2,8,25.0,6,12,8,4,0,6,17,0
Holstein Kiel,Andu Kelati,de GER,MF,21.0,3.2,7,4,2,4,1,2,5,40.0,3,4,1,3,3,10,3,0
Holstein Kiel,Ivan Nekić,hr CRO,DF,23.0,0.8,1,1,1,0,0,1,2,50.0,1,1,0,1,3,4,2,0
Bochum,Maximilian Wittek,de GER,DF,28.0,30.2,65,42,40,19,6,38,54,70.4,16,54,8,46,27,92,89,3
Bochum,Ibrahima Sissoko,ml MLI,MF,26.0,29.2,66,44,30,31,5,24,45,53.3,21,39,11,28,36,102,61,0
Bochum,Felix Passlack,de GER,DF,26.0,26.1,53,23,32,13,8,30,55,54.5,25,42,11,31,18,71,63,1
Bochum,Matúš Bero,sk SVK,MF,28.0,28.6,65,35,33,21,11,29,60,48.3,31,37,9,28,17,82,35,1
Bochum,Philipp Hofmann,de GER,FW,31.0,25.5,17,12,4,6,7,8,15,53.3,7,14,1,13,4,21,33,0
Bochum,Tim Oermann,de GER,DF,20.0,24.7,50,31,25,21,4,26,43,60.5,17,32,16,16,22,72,64,0
Bochum,Patrick Drewes,de GER,GK,31.0,21.0,0,0,0,0,0,0,1,0.0,1,1,0,1,0,0,11,1
Bochum,Ivan Ordets,ua UKR,DF,32.0,20.7,18,8,13,5,0,10,13,76.9,3,29,16,13,41,59,139,3
Bochum,Bernardo,br BRA,DF,29.0,19.8,46,28,32,13,1,27,37,73.0,10,38,17,21,26,72,103,4
Bochum,Jakov Medić,hr CRO,DF,25.0,17.9,13,11,9,3,1,8,18,44.4,10,32,21,11,22,35,111,4
Bochum,Moritz Broschinski,de GER,FW,23.0,15.6,19,14,6,6,7,6,15,40.0,9,18,0,18,1,20,18,0
Bochum,Timo Horn,de GER,GK,31.0,13.0,0,0,0,0,0,0,0,,0,0,0,0,0,0,9,2
Bochum,Anthony Losilla,fr FRA,MF,38.0,12.7,30,16,15,12,3,17,33,51.5,16,22,7,15,18,48,27,1
Bochum,Tom Krauß,de GER,MF,23.0,12.0,35,18,20,13,2,19,38,50.0,19,26,2,24,11,46,19,1
Bochum,Gerrit Holtmann,ph PHI,DF,29.0,12.7,24,19,14,8,2,12,24,50.0,12,18,5,13,16,40,15,0
Bochum,Giorgos Masouras,gr GRE,FW,30.0,11.8,18,10,6,7,5,7,16,43.8,9,9,1,8,4,22,3,1
Bochum,Dani de Wit,nl NED,MF,26.0,12.9,29,17,11,15,3,18,31,58.1,13,17,4,13,12,41,23,1
Bochum,Myron Boadu,nl NED,FW,23.0,11.7,2,1,0,0,2,1,5,20.0,4,3,0,3,1,3,4,0
Bochum,Erhan Mašović,rs SRB,DF,25.0,10.1,14,10,10,4,0,13,28,46.4,15,17,11,6,12,26,55,0
Bochum,Koji Miyoshi,jp JPN,FW,27.0,5.2,8,5,2,1,5,4,9,44.4,5,10,1,9,2,10,2,0
Bochum,Lukas Daschner,de GER,MF,25.0,4.6,4,2,1,2,1,2,9,22.2,7,5,0,5,0,4,5,0
Bochum,Mats Pannewig,de GER,MF,19.0,3.0,10,6,7,3,0,3,12,25.0,9,8,1,7,2,12,8,0
Bochum,Cristian Gamboa,cr CRC,DF,34.0,2.5,8,3,5,3,0,3,9,33.3,6,2,0,2,2,10,8,0
Bochum,Moritz-Broni Kwarteng,gh GHA,MF,26.0,1.9,4,3,1,1,2,1,2,50.0,1,0,0,0,0,4,1,0
Bochum,Aliou Badara Baldé,gn GUI,MF,21.0,1.0,1,1,1,0,0,0,0,,0,2,0,2,0,1,0,0
Bochum,Samuel Bamba,de GER,FW,20.0,0.3,1,1,1,0,0,0,0,,0,0,0,0,0,1,0,0
Bochum,Kacper Koscierski,de GER,DF,17.0,0.1,0,0,0,0,0,0,0,,0,0,0,0,0,0,0,0
Liverpool,Mohamed Salah,eg EGY,FW,32.0,37.6,21,11,7,5,9,8,17,47.1,9,12,0,12,9,30,5,0
Liverpool,Virgil van Dijk,nl NED,DF,33.0,37.0,38,20,17,19,2,13,22,59.1,9,27,16,11,56,94,190,4
Liverpool,Ryan Gravenberch,nl NED,MF,22.0,35.2,69,35,27,29,13,32,56,57.1,24,35,10,25,60,129,59,2
Liverpool,Alexis Mac Allister,ar ARG,MF,25.0,29.0,95,58,28,51,16,55,104,52.9,49,61,6,55,22,117,29,1
Liverpool,Ibrahima Konaté,fr FRA,DF,25.0,28.5,40,26,25,13,2,25,35,71.4,10,29,15,14,17,57,133,3
Liverpool,Dominik Szoboszlai,hu HUN,MF,23.0,27.8,38,20,14,19,5,17,45,37.8,28,39,5,34,9,47,19,2
Liverpool,Andrew Robertson,sct SCO,DF,30.0,27.7,39,22,25,10,4,31,51,60.8,20,10,4,6,21,60,54,2
Liverpool,Alisson,br BRA,GK,31.0,27.9,1,0,1,0,0,0,1,0.0,1,0,0,0,0,1,13,1
Liverpool,Luis Díaz,co COL,FW,27.0,26.9,39,26,13,20,6,15,39,38.5,24,19,0,19,7,46,7,1
Liverpool,Trent Alexander-Arnold,eng ENG,DF,25.0,26.5,72,50,44,19,9,49,105,46.7,56,26,9,17,31,103,55,4
Liverpool,Cody Gakpo,nl NED,FW,25.0,21.7,28,16,6,13,9,13,25,52.0,12,23,3,20,12,40,19,1
Liverpool,Curtis Jones,eng ENG,MF,23.0,19.2,39,22,6,23,10,17,27,63.0,10,22,9,13,7,46,10,3
Liverpool,Diogo Jota,pt POR,FW,27.0,13.4,14,8,2,8,4,7,19,36.8,12,9,0,9,8,22,6,0
Liverpool,Caoimhín Kelleher,ie IRL,GK,25.0,10.0,0,0,0,0,0,0,0,,0,0,0,0,0,0,1,2
Liverpool,Kostas Tsimikas,gr GRE,DF,28.0,9.3,31,20,15,11,5,14,23,60.9,9,5,2,3,11,42,20,0
Liverpool,Darwin Núñez,uy URU,FW,25.0,12.7,21,18,11,4,6,7,18,38.9,11,6,0,6,4,25,12,0
Liverpool,Conor Bradley,nir NIR,DF,21.0,8.4,14,10,7,5,2,11,22,50.0,11,9,2,7,4,18,31,0
Liverpool,Joe Gomez,eng ENG,DF,27.0,5.8,13,10,5,7,1,11,16,68.8,5,9,6,3,7,20,20,2
Liverpool,Jarell Quansah,eng ENG,DF,21.0,5.5,12,8,8,4,0,7,10,70.0,3,10,7,3,7,19,28,1
Liverpool,Harvey Elliott,eng ENG,MF,21.0,4.1,5,3,3,1,1,2,8,25.0,6,7,2,5,1,6,3,1
Liverpool,Wataru Endo,jp JPN,MF,31.0,3.0,12,8,7,5,0,6,10,60.0,4,8,1,7,6,18,9,0
Liverpool,Federico Chiesa,it ITA,FW,26.0,1.2,1,0,0,1,0,0,2,0.0,2,1,0,1,0,1,1,1
Liverpool,Vitezslav Jaros,cz CZE,GK,23.0,0.1,0,0,0,0,0,0,0,,0,0,0,0,0,0,0,0
Liverpool,Jayden Danns,eng ENG,MF,18.0,0.1,0,0,0,0,0,0,1,0.0,1,0,0,0,0,0,0,0
Arsenal,David Raya,es ESP,GK,28.0,38.0,0,0,0,0,0,0,2,0.0,2,0,0,0,2,2,21,9
Arsenal,William Saliba,fr FRA,DF,23.0,33.8,62,37,37,23,2,21,28,75.0,7,25,15,10,21,83,119,7
Arsenal,Declan Rice,eng ENG,MF,25.0,31.5,53,25,22,25,6,17,41,41.5,24,27,13,14,25,78,51,0
Arsenal,Thomas Partey,gh GHA,MF,31.0,31.1,89,53,26,39,24,46,76,60.5,30,29,9,20,35,124,49,4
Arsenal,Leandro Trossard,be BEL,FW,29.0,28.4,31,20,6,16,9,12,34,35.3,22,32,0,32,9,40,18,0
Arsenal,Gabriel Magalhães,br BRA,DF,26.0,26.3,25,15,12,8,5,12,16,75.0,4,42,29,13,16,41,93,2
Arsenal,Jurriën Timber,nl NED,DF,23.0,27.0,58,38,17,30,11,18,27,66.7,9,19,4,15,22,80,44,1
Arsenal,Martin Ødegaard,no NOR,MF,25.0,26.0,19,11,9,7,3,4,25,16.0,21,5,0,5,6,25,6,1
Arsenal,Gabriel Martinelli,br BRA,FW,23.0,25.6,23,15,9,6,8,7,23,30.4,16,15,0,15,5,28,19,0
Arsenal,Kai Havertz,de GER,FW,25.0,20.9,16,9,3,6,7,4,15,26.7,11,23,4,19,6,22,33,1
Arsenal,Bukayo Saka,eng ENG,FW,22.0,19.3,29,15,9,11,9,13,24,54.2,11,22,0,22,3,32,8,0
Arsenal,Mikel Merino,es ESP,MF,28.0,17.7,46,28,7,26,13,20,36,55.6,16,18,5,13,15,61,26,2
Arsenal,Myles Lewis-Skelly,eng ENG,DF,17.0,15.3,22,14,10,9,3,10,11,90.9,1,4,1,3,7,29,27,0
Arsenal,Ben White,eng ENG,DF,26.0,13.3,20,14,10,4,6,16,38,42.1,22,10,8,2,16,36,44,0
Arsenal,Riccardo Calafiori,it ITA,DF,22.0,11.0,27,19,15,10,2,18,29,62.1,11,12,6,6,9,36,25,0
Arsenal,Ethan Nwaneri,eng ENG,FW,17.0,10.0,11,7,4,4,3,7,21,33.3,14,8,2,6,2,13,4,1
Arsenal,Jakub Kiwior,pl POL,DF,24.0,12.5,22,8,13,7,2,11,15,73.3,4,13,8,5,6,28,58,3
Arsenal,Jorginho,it ITA,MF,32.0,7.9,12,4,1,7,4,8,20,40.0,12,3,0,3,7,19,2,2
Arsenal,Raheem Sterling,eng ENG,FW,29.0,5.6,9,4,1,3,5,5,10,50.0,5,3,0,3,1,10,4,0
Arsenal,Gabriel Jesus,br BRA,FW,27.0,6.8,10,6,4,3,3,4,9,44.4,5,10,1,9,4,14,8,0
Arsenal,Oleksandr Zinchenko,ua UKR,DF,27.0,5.9,6,1,1,3,2,3,8,37.5,5,8,1,7,5,11,10,0
Arsenal,Kieran Tierney,sct SCO,DF,27.0,2.9,7,5,4,1,2,4,6,66.7,2,0,0,0,3,10,9,0
Arsenal,Nathan Butler-Oyedeji,eng ENG,FW,21.0,0.1,0,0,0,0,0,0,0,,0,0,0,0,0,0,0,0
Arsenal,Takehiro Tomiyasu,jp JPN,DF,25.0,0.1,0,0,0,0,0,0,0,,0,0,0,0,0,0,1,0
Arsenal,Reiss Nelson,eng ENG,FW,24.0,0.0,1,0,0,1,0,0,1,0.0,1,0,0,0,0,1,1,0
Manchester City,Joško Gvardiol,hr CRO,DF,22.0,36.4,58,39,25,21,12,21,40,52.5,19,42,20,22,44,102,122,8
Manchester City,Erling Haaland,no NOR,FW,24.0,30.5,11,6,3,3,5,3,8,37.5,5,12,1,11,5,16,23,0
Manchester City,Bernardo Silva,pt POR,MF,29.0,29.7,56,37,17,30,9,25,56,44.6,31,36,7,29,23,79,32,3
Manchester City,Ederson,br BRA,GK,30.0,25.8,0,0,0,0,0,0,2,0.0,2,0,0,0,1,1,11,4
Manchester City,Rúben Dias,pt POR,DF,27.0,25.2,17,11,7,9,1,7,13,53.8,6,23,20,3,20,37,71,4
Manchester City,İlkay Gündoğan,de GER,MF,33.0,24.8,25,13,5,15,5,10,24,41.7,14,15,0,15,13,38,23,0
Manchester City,Mateo Kovačić,hr CRO,MF,30.0,24.5,69,38,23,38,8,31,65,47.7,34,20,0,20,24,93,21,1
Manchester City,Manuel Akanji,ch SUI,DF,29.0,22.4,19,12,12,4,3,11,17,64.7,6,11,8,3,9,28,64,3
Manchester City,Rico Lewis,eng ENG,DF,19.0,21.1,30,19,13,12,5,13,21,61.9,8,28,7,21,13,43,45,1
Manchester City,Sávio,br BRA,FW,20.0,19.8,23,17,5,10,8,10,19,52.6,9,14,2,12,6,29,9,1
Manchester City,Phil Foden,eng ENG,MF,24.0,19.9,13,5,5,4,4,7,18,38.9,11,13,1,12,9,22,7,1
Manchester City,Kevin De Bruyne,be BEL,MF,33.0,19.0,17,9,7,5,5,5,23,21.7,18,8,0,8,7,24,10,1
Manchester City,Matheus Nunes,pt POR,DF,25.0,18.6,35,22,15,14,6,16,38,42.1,22,17,4,13,15,50,38,2
Manchester City,Jeremy Doku,be BEL,FW,22.0,17.0,31,22,9,12,10,8,15,53.3,7,11,1,10,4,35,2,0
Manchester City,Omar Marmoush,eg EGY,FW,25.0,13.2,13,8,2,9,2,8,16,50.0,8,15,1,14,6,19,3,0
Manchester City,Stefan Ortega,de GER,GK,31.0,12.2,0,0,0,0,0,0,1,0.0,1,0,0,0,0,0,11,1
Manchester City,Kyle Walker,eng ENG,DF,34.0,10.8,17,10,7,7,3,14,26,53.8,12,13,4,9,3,20,13,1
Manchester City,Nicolás González,es ESP,MF,22.0,8.5,16,6,5,7,4,6,11,54.5,5,9,0,9,8,24,21,0
Manchester City,Nathan Aké,nl NED,DF,29.0,7.6,9,7,7,2,0,4,6,66.7,2,7,2,5,3,12,22,1
Manchester City,Jack Grealish,eng ENG,FW,28.0,8.1,9,5,4,2,3,2,5,40.0,3,12,2,10,2,11,6,1
Manchester City,John Stones,eng ENG,DF,30.0,6.1,6,2,3,2,1,5,5,100.0,0,5,3,2,4,10,19,1
Manchester City,Nico O’Reilly,eng ENG,DF,19.0,5.9,9,4,3,3,3,4,8,50.0,4,5,1,4,4,13,12,0
Manchester City,Abdukodir Khusanov,uz UZB,DF,20.0,5.6,5,4,4,1,0,2,3,66.7,1,5,4,1,3,8,29,1
Manchester City,James Mcatee,eng ENG,MF,21.0,3.9,5,2,0,4,1,1,7,14.3,6,8,0,8,2,7,1,0
Manchester City,Jahmai Simpson-Pusey,eng ENG,DF,18.0,1.1,1,0,1,0,0,0,1,0.0,1,1,1,0,0,1,2,0
Manchester City,Rodri,es ESP,MF,28.0,0.8,2,1,1,1,0,0,0,,0,1,0,1,1,3,1,0
Manchester City,Divin Mubama,eng ENG,FW,19.0,0.3,0,0,0,0,0,0,0,,0,0,0,0,0,0,0,0
Manchester City,Oscar Bobb,no NOR,FW,21.0,0.2,0,0,0,0,0,0,0,,0,0,0,0,0,0,0,0
Manchester City,Claudio Echeverri,ar ARG,FW,18.0,0.1,1,0,0,1,0,1,1,100.0,0,0,0,0,0,1,0,0
Manchester City,Vitor Reis,br BRA,DF,18.0,0.0,0,0,0,0,0,0,0,,0,0,0,0,0,0,1,0
Chelsea,Moisés Caicedo,ec ECU,MF,22.0,37.3,114,73,44,54,16,54,86,62.8,32,49,10,39,49,163,60,1
Chelsea,Cole Palmer,eng ENG,MF,22.0,35.6,34,20,12,10,12,12,27,44.4,15,16,1,15,11,45,20,1
Chelsea,Levi Colwill,eng ENG,DF,21.0,35.0,47,34,25,19,3,18,27,66.7,9,37,25,12,33,80,118,4
Chelsea,Marc Cucurella,es ESP,DF,26.0,33.3,67,45,31,31,5,32,61,52.5,29,49,16,33,28,95,95,3
Chelsea,Enzo Fernández,ar ARG,MF,23.0,32.8,65,33,17,30,18,31,84,36.9,53,43,7,36,13,78,23,4
Chelsea,Robert Sánchez,es ESP,GK,26.0,32.0,0,0,0,0,0,0,1,0.0,1,0,0,0,2,2,24,10
Chelsea,Nicolas Jackson,sn SEN,FW,23.0,24.9,22,13,6,7,9,5,10,50.0,5,15,2,13,3,25,15,0
Chelsea,Noni Madueke,eng ENG,FW,22.0,22.8,25,18,8,12,5,14,38,36.8,24,17,0,17,10,35,11,0
Chelsea,Pedro Neto,pt POR,FW,24.0,25.3,23,9,9,9,5,9,21,42.9,12,14,2,12,9,32,6,0
Chelsea,Malo Gusto,fr FRA,DF,21.0,20.7,45,29,27,15,3,25,48,52.1,23,29,8,21,24,69,49,5
Chelsea,Jadon Sancho,eng ENG,FW,24.0,19.7,13,7,3,3,7,5,12,41.7,7,11,0,11,2,15,8,2
Chelsea,Tosin Adarabioyo,eng ENG,DF,26.0,15.7,17,13,11,6,0,8,12,66.7,4,9,7,2,11,28,80,0
Chelsea,Wesley Fofana,fr FRA,DF,23.0,13.1,13,12,6,7,0,6,14,42.9,8,14,9,5,14,27,55,2
Chelsea,Reece James,eng ENG,DF,24.0,11.9,10,9,6,3,1,3,9,33.3,6,14,6,8,13,23,23,4
Chelsea,Trevoh Chalobah,eng ENG,DF,25.0,10.1,11,7,5,6,0,7,8,87.5,1,6,3,3,10,21,48,1
Chelsea,Roméo Lavia,be BEL,MF,20.0,9.0,22,13,5,13,4,10,21,47.6,11,6,0,6,16,38,10,1
Chelsea,Christopher Nkunku,fr FRA,FW,26.0,10.3,12,8,3,4,5,6,8,75.0,2,9,2,7,7,19,10,0
Chelsea,Filip Jørgensen,dk DEN,GK,22.0,6.0,0,0,0,0,0,0,0,,0,0,0,0,0,0,0,3
Chelsea,Axel Disasi,fr FRA,DF,26.0,4.1,7,4,5,1,1,6,11,54.5,5,4,1,3,2,9,11,1
Chelsea,João Félix,pt POR,FW,24.0,4.1,8,3,2,5,1,5,9,55.6,4,2,0,2,3,11,2,0
Chelsea,Benoît Badiashile,fr FRA,DF,23.0,3.7,9,6,5,4,0,4,5,80.0,1,2,2,0,6,15,12,2
Chelsea,Kiernan Dewsbury-Hall,eng ENG,MF,25.0,3.0,8,5,1,1,6,4,6,66.7,2,2,0,2,2,10,9,1
Chelsea,Joshua Acheampong,eng ENG,DF,18.0,1.9,2,1,2,0,0,2,2,100.0,0,1,0,1,1,3,2,0
Chelsea,Tyrique George,eng ENG,FW,18.0,2.0,2,0,2,0,0,2,3,66.7,1,1,0,1,2,4,1,0
Chelsea,Renato Veiga,pt POR,DF,21.0,2.0,9,6,6,3,0,4,12,33.3,8,3,1,2,1,10,2,0
Chelsea,Mykhailo Mudryk,ua UKR,FW,23.0,1.7,2,2,2,0,0,0,0,,0,3,1,2,0,2,1,0
Chelsea,Marc Guiu,es ESP,FW,18.0,0.8,1,1,0,1,0,1,1,100.0,0,0,0,0,0,1,0,0
Chelsea,Mathis Amougou,fr FRA,MF,18.0,0.1,0,0,0,0,0,0,0,,0,0,0,0,0,0,0,0
Chelsea,Shumaira Mheuka,eng ENG,MF,16.0,0.0,0,0,0,0,0,0,0,,0,0,0,0,0,0,0,0
Newcastle United,Bruno Guimarães,br BRA,MF,26.0,36.5,83,47,41,30,12,33,69,47.8,36,36,10,26,29,112,44,5
Newcastle United,Dan Burn,eng ENG,DF,32.0,37.0,39,24,22,15,2,20,36,55.6,16,36,26,10,27,66,197,4
Newcastle United,Alexander Isak,se SWE,FW,24.0,30.8,12,5,2,3,7,5,15,33.3,10,18,2,16,3,15,17,1
Newcastle United,Fabian Schär,ch SUI,DF,32.0,32.6,36,21,16,18,2,14,35,40.0,21,38,25,13,45,81,138,3
Newcastle United,Valentino Livramento,eng ENG,DF,21.0,31.6,54,36,35,15,4,32,59,54.2,27,37,11,26,23,77,108,1
Newcastle United,Jacob Murphy,eng ENG,FW,29.0,26.5,28,19,10,12,6,20,44,45.5,24,31,0,31,13,41,35,1
Newcastle United,Joelinton,br BRA,MF,27.0,26.7,57,35,23,23,11,25,44,56.8,19,37,7,30,23,80,47,2
Newcastle United,Sandro Tonali,it ITA,MF,24.0,29.3,51,32,22,23,6,25,51,49.0,26,34,11,23,34,85,33,2
Newcastle United,Nick Pope,eng ENG,GK,32.0,28.0,0,0,0,0,0,0,0,,0,1,0,1,1,1,32,5
Newcastle United,Anthony Gordon,eng ENG,FW,23.0,27.2,32,18,9,18,5,12,37,32.4,25,25,2,23,7,39,9,3
Newcastle United,Lewis Hall,eng ENG,DF,19.0,24.4,58,41,28,22,8,40,74,54.1,34,33,18,15,18,76,75,3
Newcastle United,Harvey Barnes,eng ENG,FW,26.0,19.6,16,9,4,6,6,3,11,27.3,8,8,2,6,6,22,15,1
Newcastle United,Kieran Trippier,eng ENG,DF,33.0,14.7,38,21,18,14,6,22,36,61.1,14,11,3,8,12,50,49,0
Newcastle United,Joe Willock,eng ENG,MF,24.0,12.2,30,17,15,12,3,18,31,58.1,13,24,6,18,6,36,7,0
Newcastle United,Martin Dúbravka,sk SVK,GK,35.0,10.0,0,0,0,0,0,0,0,,0,0,0,0,0,0,3,0
Newcastle United,Sean Longstaff,eng ENG,MF,26.0,8.9,27,16,10,9,8,18,27,66.7,9,17,5,12,7,34,8,0
Newcastle United,Sven Botman,nl NED,DF,24.0,4.6,12,9,6,5,1,7,9,77.8,2,5,4,1,5,17,25,1
Newcastle United,Lloyd Kelly,eng ENG,DF,25.0,3.4,5,4,4,1,0,1,1,100.0,0,6,4,2,1,6,17,0
Newcastle United,Callum Wilson,eng ENG,FW,32.0,4.1,2,2,0,1,1,0,2,0.0,2,2,0,2,1,3,1,0
Newcastle United,Emil Krafth,se SWE,DF,29.0,3.8,4,2,2,1,1,2,3,66.7,1,5,4,1,2,6,16,0
Newcastle United,Lewis Miley,eng ENG,MF,18.0,3.5,14,11,5,7,2,7,14,50.0,7,5,1,4,2,16,5,2
Newcastle United,Miguel Almirón,py PAR,FW,30.0,1.8,3,2,2,0,1,2,3,66.7,1,2,0,2,0,3,0,0
Newcastle United,William Osula,dk DEN,FW,20.0,1.5,2,0,1,0,1,0,2,0.0,2,0,0,0,4,6,2,0
Newcastle United,Matt Targett,eng ENG,DF,28.0,0.2,0,0,0,0,0,0,1,0.0,1,0,0,0,1,1,1,0
Aston Villa,Emiliano Martínez,ar ARG,GK,31.0,35.5,3,3,3,0,0,2,2,100.0,0,1,0,1,0,3,17,6
Aston Villa,Morgan Rogers,eng ENG,FW,22.0,34.8,43,22,15,15,13,24,47,51.1,23,26,7,19,6,49,20,2
Aston Villa,Youri Tielemans,be BEL,MF,27.0,33.7,84,58,32,44,8,40,73,54.8,33,38,16,22,23,107,47,4
Aston Villa,Ezri Konsa,eng ENG,DF,26.0,32.6,34,18,20,10,4,20,25,80.0,5,20,11,9,24,58,114,4
Aston Villa,Ollie Watkins,eng ENG,FW,28.0,29.1,10,7,0,6,4,3,11,27.3,8,11,3,8,8,18,15,2
Aston Villa,Lucas Digne,fr FRA,DF,31.0,26.3,65,38,40,16,9,44,66,66.7,22,23,4,19,25,90,89,1
Aston Villa,John McGinn,sct SCO,MF,29.0,24.9,33,24,10,14,9,13,31,41.9,18,22,2,20,14,47,18,3
Aston Villa,Matty Cash,pl POL,DF,26.0,23.1,56,32,29,21,6,31,43,72.1,12,22,8,14,23,79,70,2
Aston Villa,Pau Torres,es ESP,DF,27.0,22.5,21,15,11,8,2,10,17,58.8,7,16,11,5,10,31,75,2
Aston Villa,Boubacar Kamara,fr FRA,MF,24.0,19.3,50,21,28,18,4,29,56,51.8,27,19,7,12,19,69,51,3
Aston Villa,Amadou Onana,be BEL,MF,22.0,18.1,55,30,23,26,6,16,29,55.2,13,16,7,9,26,81,41,3
Aston Villa,Jacob Ramsey,eng ENG,FW,23.0,18.2,30,15,14,10,6,10,20,50.0,10,23,4,19,8,38,8,1
Aston Villa,Leon Bailey,jm JAM,FW,26.0,12.8,7,5,2,3,2,3,11,27.3,8,6,0,6,3,10,12,0
Aston Villa,Tyrone Mings,eng ENG,DF,31.0,12.5,7,6,6,1,0,2,2,100.0,0,13,11,2,7,14,61,1
Aston Villa,Ian Maatsen,nl NED,DF,22.0,12.7,29,17,17,9,3,17,24,70.8,7,13,0,13,15,44,39,3
Aston Villa,Marco Asensio,es ESP,MF,28.0,8.3,7,5,0,7,0,3,9,33.3,6,7,1,6,2,9,3,0
Aston Villa,Diego Carlos,br BRA,DF,31.0,9.2,8,3,6,1,1,4,6,66.7,2,13,7,6,5,13,36,2
Aston Villa,Axel Disasi,fr FRA,DF,26.0,5.4,8,5,7,1,0,3,7,42.9,4,4,1,3,5,13,18,0
Aston Villa,Lamare Bogarde,nl NED,DF,20.0,5.3,14,6,6,6,2,10,16,62.5,6,5,3,2,1,15,13,0
Aston Villa,Andrés García,es ESP,DF,21.0,3.5,9,5,5,3,1,4,8,50.0,4,2,0,2,2,11,10,2
Aston Villa,Jáder Durán,co COL,FW,20.0,7.1,8,7,1,2,5,1,4,25.0,3,5,0,5,0,8,13,0
Aston Villa,Marcus Rashford,eng ENG,FW,26.0,5.0,10,7,2,3,5,4,6,66.7,2,2,0,2,1,11,3,0
Aston Villa,Ross Barkley,eng ENG,MF,30.0,6.5,14,3,4,10,0,9,14,64.3,5,9,3,6,10,24,5,0
Aston Villa,Jaden Philogene Bidace,eng ENG,FW,22.0,3.7,11,5,4,7,0,4,6,66.7,2,5,0,5,3,14,2,1
Aston Villa,Donyell Malen,nl NED,FW,25.0,3.4,7,4,3,3,1,1,4,25.0,3,2,0,2,0,7,1,0
Aston Villa,Robin Olsen,se SWE,GK,34.0,2.5,1,0,1,0,0,1,1,100.0,0,0,0,0,0,1,2,1
Aston Villa,Kosta Nedeljković,rs SRB,DF,18.0,1.4,7,5,1,3,3,2,3,66.7,1,1,0,1,0,7,3,0
Aston Villa,Emi Buendía,ar ARG,MF,27.0,1.1,6,6,3,2,1,0,5,0.0,5,5,1,4,0,6,2,0
Nottingham Forest,Matz Sels,be BEL,GK,32.0,38.0,1,1,1,0,0,1,1,100.0,0,0,0,0,0,1,26,1
Nottingham Forest,Nikola Milenković,rs SRB,DF,26.0,37.0,51,29,36,13,2,27,34,79.4,7,41,24,17,27,78,209,1
Nottingham Forest,Murillo,br BRA,DF,22.0,35.5,53,36,38,12,3,27,46,58.7,19,69,45,24,36,89,249,3
Nottingham Forest,Ola Aina,ng NGA,DF,27.0,33.4,55,42,39,15,1,36,64,56.3,28,34,12,22,33,88,115,4
Nottingham Forest,Chris Wood,nz NZL,FW,32.0,33.1,6,5,2,2,2,3,11,27.3,8,12,7,5,5,11,29,1
Nottingham Forest,Morgan Gibbs-White,eng ENG,MF,24.0,31.4,43,22,14,23,6,17,33,51.5,16,18,5,13,23,66,29,1
Nottingham Forest,Elliot Anderson,eng ENG,MF,21.0,30.5,92,56,54,29,9,48,111,43.2,63,48,9,39,31,123,76,4
Nottingham Forest,Anthony Elanga,se SWE,FW,22.0,28.0,19,14,8,8,3,5,17,29.4,12,11,1,10,6,25,25,0
Nottingham Forest,Neco Williams,wls WAL,DF,23.0,28.9,90,57,63,19,8,53,86,61.6,33,42,10,32,31,121,137,3
Nottingham Forest,Callum Hudson-Odoi,eng ENG,FW,23.0,24.6,22,14,8,8,6,12,18,66.7,6,11,0,11,13,35,12,1
Nottingham Forest,Nicolás Domínguez,ar ARG,MF,26.0,22.0,86,45,40,35,11,36,76,47.4,40,38,12,26,29,115,54,1
Nottingham Forest,Ryan Yates,eng ENG,MF,26.0,21.3,42,21,24,14,4,17,37,45.9,20,38,10,28,26,68,61,1
Nottingham Forest,Álex Moreno,es ESP,DF,31.0,10.7,25,18,20,5,0,15,39,38.5,24,11,5,6,15,40,43,0
Nottingham Forest,Ibrahim Sangaré,ci CIV,MF,26.0,6.6,28,14,8,17,3,8,17,47.1,9,10,4,6,6,34,13,1
Nottingham Forest,Morato,br BRA,DF,23.0,10.1,22,14,18,3,1,13,21,61.9,8,14,5,9,10,32,78,2
Nottingham Forest,Jota Silva,pt POR,FW,24.0,9.5,27,14,12,13,2,6,27,22.2,21,9,1,8,12,39,17,0
Nottingham Forest,James Ward-Prowse,eng ENG,MF,29.0,4.5,4,1,1,3,0,2,2,100.0,0,3,2,1,5,9,8,0
Nottingham Forest,Danilo,br BRA,MF,23.0,3.1,8,4,7,1,0,3,6,50.0,3,2,1,1,4,12,3,0
Nottingham Forest,Taiwo Awoniyi,ng NGA,FW,26.0,4.6,6,3,0,3,3,4,5,80.0,1,1,0,1,0,6,7,0
Nottingham Forest,Ramón Sosa,py PAR,FW,24.0,3.3,5,3,3,0,2,1,5,20.0,4,9,0,9,4,9,5,0
Nottingham Forest,Willy Boly,ci CIV,DF,33.0,1.7,6,1,5,1,0,4,4,100.0,0,4,2,2,3,9,12,0
Nottingham Forest,Harry Toffolo,eng ENG,DF,28.0,1.5,5,3,3,1,1,3,4,75.0,1,2,2,0,2,7,12,0
Nottingham Forest,Eric da Silva Moreira,de GER,MF,18.0,0.3,2,2,2,0,0,2,6,33.3,4,0,0,0,1,3,0,0
Brighton and Hove Albion,Bart Verbruggen,nl NED,GK,21.0,36.0,0,0,0,0,0,0,3,0.0,3,1,0,1,0,0,29,5
Brighton and Hove Albion,Jan Paul van Hecke,nl NED,DF,24.0,32.9,45,29,24,19,2,23,41,56.1,18,37,22,15,24,69,142,2
Brighton and Hove Albion,Carlos Baleba,cm CMR,MF,20.0,29.7,79,46,26,37,16,48,80,60.0,32,47,11,36,46,125,44,1
Brighton and Hove Albion,Kaoru Mitoma,jp JPN,FW,27.0,29.1,45,27,15,14,16,19,49,38.8,30,48,3,45,14,59,10,0
Brighton and Hove Albion,Pervis Estupiñán,ec ECU,DF,26.0,26.7,65,43,33,25,7,34,51,66.7,17,20,5,15,37,102,65,2
Brighton and Hove Albion,Danny Welbeck,eng ENG,FW,33.0,23.6,26,16,6,15,5,8,20,40.0,12,19,4,15,5,31,14,0
Brighton and Hove Albion,Lewis Dunk,eng ENG,DF,32.0,23.2,17,10,8,7,2,11,19,57.9,8,28,18,10,13,30,79,2
Brighton and Hove Albion,João Pedro,br BRA,FW,22.0,21.7,16,12,6,6,4,4,11,36.4,7,12,0,12,9,25,12,0
Brighton and Hove Albion,Yasin Ayari,se SWE,MF,20.0,22.0,59,32,15,31,13,26,56,46.4,30,24,6,18,20,79,26,0
Brighton and Hove Albion,Jack Hinshelwood,eng ENG,MF,19.0,20.6,27,19,8,10,9,11,27,40.7,16,10,3,7,16,43,37,1
Brighton and Hove Albion,Yankuba Minteh,gm GAM,FW,20.0,20.6,48,35,25,13,10,17,45,37.8,28,22,0,22,11,59,31,0
Brighton and Hove Albion,Joël Veltman,nl NED,DF,32.0,18.9,43,29,24,16,3,31,52,59.6,21,22,7,15,19,62,66,0
Brighton and Hove Albion,Georginio Rutter,fr FRA,MF,22.0,18.6,39,15,13,18,8,14,36,38.9,22,20,3,17,10,49,13,2
Brighton and Hove Albion,Simon Adingra,ci CIV,FW,22.0,12.3,23,14,10,8,5,10,26,38.5,16,12,0,12,8,31,6,2
Brighton and Hove Albion,Matt O'Riley,dk DEN,MF,23.0,10.5,16,9,4,8,4,4,13,30.8,9,7,3,4,13,29,9,1
Brighton and Hove Albion,Adam Webster,eng ENG,DF,29.0,9.9,10,6,5,4,1,6,14,42.9,8,16,9,7,20,30,41,2
Brighton and Hove Albion,Mats Wieffer,nl NED,DF,24.0,11.3,58,34,27,27,4,32,47,68.1,15,18,2,16,17,75,28,3
Brighton and Hove Albion,Igor,br BRA,DF,26.0,10.7,5,5,2,2,1,4,10,40.0,6,24,14,10,4,9,39,1
Brighton and Hove Albion,Tariq Lamptey,gh GHA,DF,23.0,9.6,17,11,8,9,0,9,25,36.0,16,15,7,8,7,24,23,1
Brighton and Hove Albion,Brajan Gruda,de GER,MF,20.0,7.7,16,8,6,6,4,7,14,50.0,7,8,0,8,2,18,5,1
Brighton and Hove Albion,Ferdi Kadioglu,tr TUR,DF,24.0,4.3,10,6,4,5,1,6,15,40.0,9,2,2,0,8,18,17,0
Brighton and Hove Albion,Diego Gómez,py PAR,MF,21.0,5.8,21,13,11,8,2,12,22,54.5,10,13,0,13,8,29,10,1
Brighton and Hove Albion,James Milner,eng ENG,MF,38.0,1.9,5,2,1,3,1,3,3,100.0,0,4,2,2,2,7,2,1
Brighton and Hove Albion,Julio Enciso,py PAR,MF,20.0,3.3,0,0,0,0,0,0,2,0.0,2,2,0,2,0,0,1,0
Brighton and Hove Albion,Evan Ferguson,ie IRL,FW,19.0,2.8,4,3,0,3,1,2,5,40.0,3,3,1,2,0,4,4,0
Brighton and Hove Albion,Jason Steele,eng ENG,GK,33.0,2.0,0,0,0,0,0,0,0,,0,0,0,0,0,0,1,0
Brighton and Hove Albion,Solly March,eng ENG,FW,30.0,1.9,6,3,2,2,2,5,8,62.5,3,3,0,3,2,8,2,1
Brighton and Hove Albion,Billy Gilmour,sct SCO,MF,23.0,1.1,3,3,2,1,0,3,4,75.0,1,1,0,1,0,3,1,0
Brighton and Hove Albion,Eiran Cashin,ie IRL,DF,22.0,0.2,0,0,0,0,0,0,1,0.0,1,0,0,0,0,0,2,0
Brighton and Hove Albion,Jakub Moder,pl POL,MF,25.0,0.1,1,0,1,0,0,0,2,0.0,2,0,0,0,0,1,3,0
Brighton and Hove Albion,Jeremy Sarmiento,ec ECU,MF,22.0,0.1,0,0,0,0,0,0,0,,0,0,0,0,0,0,0,0
Brighton and Hove Albion,Harry Howell,eng ENG,FW,15.0,0.1,1,1,1,0,0,1,2,50.0,1,1,0,1,0,1,0,0
Bournemouth,Milos Kerkez,hu HUN,DF,20.0,37.1,52,26,25,20,7,24,38,63.2,14,38,11,27,45,97,106,4
Bournemouth,Antoine Semenyo,gh GHA,FW,24.0,35.7,55,35,17,25,13,16,43,37.2,27,67,9,58,11,66,39,2
Bournemouth,Illia Zabarnyi,ua UKR,DF,21.0,34.6,52,36,31,20,1,34,50,68.0,16,33,20,13,41,93,182,2
Bournemouth,Lewis Cook,eng ENG,MF,27.0,33.1,81,42,41,36,4,37,67,55.2,30,30,11,19,41,122,70,0
Bournemouth,Kepa Arrizabalaga,es ESP,GK,29.0,31.0,1,0,1,0,0,0,2,0.0,2,2,0,2,0,1,15,3
Bournemouth,Justin Kluivert,nl NED,MF,25.0,26.2,23,11,4,11,8,4,22,18.2,18,24,0,24,14,37,24,1
Bournemouth,Evanilson,br BRA,FW,24.0,26.0,16,10,6,5,5,8,12,66.7,4,11,2,9,1,17,21,0
Bournemouth,Ryan Christie,sct SCO,MF,29.0,23.7,54,33,19,27,8,27,64,42.2,37,44,11,33,30,84,51,3
Bournemouth,Dean Huijsen,es ESP,DF,19.0,27.0,36,26,19,16,1,18,29,62.1,11,40,29,11,51,87,198,4
Bournemouth,Dango Ouattara,bf BFA,FW,22.0,22.4,35,26,14,11,10,17,41,41.5,24,36,10,26,11,46,51,0
Bournemouth,Tyler Adams,us USA,MF,25.0,21.9,83,50,26,49,8,39,72,54.2,33,33,10,23,32,115,42,0
Bournemouth,Marcus Tavernier,eng ENG,FW,25.0,21.6,43,24,15,19,9,10,27,37.0,17,16,3,13,5,48,11,0
Bournemouth,Adam Smith,eng ENG,DF,33.0,17.8,24,12,11,7,6,14,27,51.9,13,13,5,8,15,39,49,1
Bournemouth,Marcos Senesi,ar ARG,DF,27.0,12.3,39,21,23,14,2,14,31,45.2,17,16,7,9,14,53,58,0
Bournemouth,David Brooks,wls WAL,FW,27.0,10.8,14,6,2,8,4,2,16,12.5,14,18,2,16,5,19,9,1
Bournemouth,Alex Scott,eng ENG,MF,20.0,8.5,27,14,11,8,8,19,42,45.2,23,17,4,13,10,37,15,0
Bournemouth,Julian Araujo,mx MEX,DF,22.0,5.6,10,5,4,6,0,5,12,41.7,7,3,0,3,6,16,18,0
Bournemouth,James Hill,eng ENG,DF,22.0,5.0,15,8,6,6,3,3,11,27.3,8,5,0,5,9,24,31,0
Bournemouth,Mark Travers,ie IRL,GK,25.0,5.0,0,0,0,0,0,0,0,,0,0,0,0,0,0,5,0
Bournemouth,Enes Ünal,tr TUR,FW,27.0,3.9,1,0,0,0,1,0,3,0.0,3,1,0,1,0,1,6,0
Bournemouth,Neto,br BRA,GK,35.0,2.0,0,0,0,0,0,0,0,,0,0,0,0,0,0,1,1
Bournemouth,Luis Sinisterra,co COL,FW,25.0,2.6,7,2,3,2,2,0,4,0.0,4,3,0,3,1,8,8,0
Bournemouth,Philip Billing,dk DEN,MF,28.0,2.1,14,5,7,6,1,3,4,75.0,1,3,0,3,5,19,2,0
Bournemouth,Max Aarons,eng ENG,DF,24.0,1.0,2,2,1,1,0,1,1,100.0,0,3,1,2,1,3,0,0
Bournemouth,Daniel Jebbison,eng ENG,FW,20.0,1.3,5,3,3,2,0,4,6,66.7,2,2,1,1,1,6,1,0
Bournemouth,Ben Winterburn,eng ENG,MF,19.0,0.3,0,0,0,0,0,0,1,0.0,1,0,0,0,2,2,0,0
Bournemouth,Julio Soler,ar ARG,DF,19.0,0.1,1,1,1,0,0,1,1,100.0,0,1,0,1,0,1,0,0
Bournemouth,Remy Rees-Dottin,eng ENG,FW,18.0,0.0,0,0,0,0,0,0,0,,0,0,0,0,0,0,0,0
Bournemouth,Zain Silcott-Duberry,ms MSR,FW,19.0,0.0,1,1,0,0,1,1,1,100.0,0,0,0,0,0,1,0,0
Brentford,Nathan Collins,ie IRL,DF,23.0,38.0,40,24,23,12,5,22,36,61.1,14,77,57,20,34,74,226,3
Brentford,Bryan Mbeumo,cm CMR,FW,24.0,38.0,49,31,18,15,16,21,35,60.0,14,26,3,23,14,63,55,1
Brentford,Mark Flekken,nl NED,GK,31.0,36.4,4,4,4,0,0,3,9,33.3,6,2,0,2,0,4,26,4
Brentford,Keane Lewis-Potter,eng ENG,DF,23.0,34.5,49,27,26,16,7,31,50,62.0,19,28,10,18,21,70,76,3
Brentford,Mikkel Damsgaard,dk DEN,MF,24.0,32.6,83,44,27,29,27,31,81,38.3,50,40,3,37,27,110,31,2
Brentford,Yoane Wissa,cd COD,FW,27.0,32.6,22,12,6,8,8,11,27,40.7,16,29,8,21,8,30,21,3
Brentford,Christian Nørgaard,dk DEN,MF,30.0,31.4,79,49,37,35,7,48,81,59.3,33,52,20,32,49,128,70,1
Brentford,Sepp van den Berg,nl NED,DF,22.0,28.8,39,24,25,10,4,19,29,65.5,10,52,38,14,21,60,134,3
Brentford,Vitaly Janelt,de GER,MF,26.0,25.2,38,22,14,13,11,21,36,58.3,15,33,9,24,27,65,53,1
Brentford,Kevin Schade,de GER,FW,22.0,25.7,39,25,17,10,12,13,23,56.5,10,19,4,15,5,44,34,0
Brentford,Ethan Pinnock,jm JAM,DF,31.0,21.3,35,19,15,16,4,13,24,54.2,11,29,18,11,24,59,142,4
Brentford,Kristoffer Ajer,no NOR,DF,26.0,16.1,26,18,14,11,1,14,27,51.9,13,17,4,13,12,38,50,0
Brentford,Yehor Yarmoliuk,ua UKR,MF,20.0,16.2,49,28,21,21,7,28,55,50.9,27,26,9,17,13,62,33,0
Brentford,Mads Roerslev,dk DEN,DF,25.0,12.3,18,8,14,3,1,11,28,39.3,17,12,5,7,4,22,35,0
Brentford,Mathias Jensen,dk DEN,MF,28.0,9.6,14,10,6,6,2,8,16,50.0,8,15,4,11,8,22,13,2
Brentford,Michael Kayode,it ITA,DF,20.0,5.9,17,11,12,5,0,9,13,69.2,4,3,0,3,7,24,19,0
Brentford,Fabio Carvalho,pt POR,FW,21.0,5.1,13,9,4,4,5,6,13,46.2,7,6,1,5,3,16,2,0
Brentford,Ben Mee,eng ENG,DF,34.0,2.0,2,2,0,2,0,1,1,100.0,0,3,3,0,4,6,7,0
Brentford,Thiago,br BRA,FW,23.0,2.0,5,3,2,1,2,0,1,0.0,1,3,0,3,2,7,3,1
Brentford,Hákon Rafn Valdimarsson,is ISL,GK,22.0,1.6,0,0,0,0,0,0,0,,0,0,0,0,0,0,2,0
Brentford,Edmond-Paris Maghoma,eng ENG,MF,23.0,1.3,2,1,0,2,0,1,3,33.3,2,2,2,0,1,3,2,0
Brentford,Rico Henry,eng ENG,DF,27.0,1.1,2,2,1,0,1,0,4,0.0,4,4,1,3,1,3,2,0
Brentford,Yunus Emre Konak,tr TUR,FW,18.0,0.5,4,4,0,4,0,1,2,50.0,1,2,0,2,0,4,0,0
Brentford,Kim Jisoo,kr KOR,DF,19.0,0.3,0,0,0,0,0,0,0,,0,0,0,0,0,0,2,0
Brentford,Frank Onyeka,ng NGA,MF,26.0,0.3,0,0,0,0,0,0,0,,0,0,0,0,0,0,0,0
Brentford,Gustavo Nunes,br BRA,FW,18.0,0.1,3,2,2,0,1,2,2,100.0,0,0,0,0,0,3,2,0
Brentford,Jayden Meghoma,eng ENG,DF,18.0,0.1,0,0,0,0,0,0,0,,0,0,0,0,0,0,0,0
Brentford,Ryan Trevitt,eng ENG,MF,21.0,0.0,1,1,1,0,0,0,0,,0,0,0,0,0,1,0,0
Fulham,Bernd Leno,de GER,GK,32.0,38.0,2,2,2,0,0,2,2,100.0,0,1,0,1,0,2,11,5
Fulham,Antonee Robinson,us USA,DF,26.0,35.2,95,61,57,31,7,45,95,47.4,50,43,9,34,62,157,133,2
Fulham,Alex Iwobi,ng NGA,FW,28.0,33.3,44,25,14,21,9,22,34,64.7,12,26,1,25,14,58,29,1
Fulham,Calvin Bassey,ng NGA,DF,24.0,34.2,54,34,35,19,0,22,31,71.0,9,40,17,23,20,74,118,8
Fulham,Raúl Jiménez,mx MEX,FW,33.0,27.9,35,24,9,17,9,8,22,36.4,14,21,5,16,10,45,23,3
Fulham,Joachim Andersen,dk DEN,DF,28.0,28.7,27,18,20,6,1,15,24,62.5,9,37,28,9,34,61,188,1
Fulham,Saša Lukić,rs SRB,MF,27.0,26.2,68,39,22,40,6,23,55,41.8,32,20,7,13,28,96,35,1
Fulham,Sander Berge,no NOR,MF,26.0,24.8,50,30,23,23,4,27,39,69.2,12,27,8,19,21,71,38,1
Fulham,Emile Smith Rowe,eng ENG,MF,24.0,23.0,31,18,7,14,10,8,24,33.3,16,22,2,20,11,42,16,0
Fulham,Andreas Pereira,br BRA,MF,28.0,22.6,24,13,8,11,5,10,42,23.8,32,17,2,15,8,32,17,3
Fulham,Kenny Tete,nl NED,DF,28.0,19.8,56,38,29,14,13,23,38,60.5,15,31,12,19,32,88,67,0
Fulham,Adama Traoré,es ESP,FW,28.0,19.8,20,13,9,6,5,5,13,38.5,8,7,0,7,1,21,6,4
Fulham,Timothy Castagne,be BEL,DF,28.0,18.3,46,29,28,15,3,26,45,57.8,19,15,6,9,22,68,83,0
Fulham,Issa Diop,fr FRA,DF,27.0,14.9,26,12,18,8,0,13,18,72.2,5,10,7,3,9,35,72,2
Fulham,Harry Wilson,wls WAL,FW,27.0,13.0,20,14,13,3,4,12,18,66.7,6,15,1,14,7,27,10,1
Fulham,Rodrigo Muniz,br BRA,FW,23.0,10.8,10,5,3,5,2,4,4,100.0,0,9,2,7,5,15,14,0
Fulham,Ryan Sessegnon,eng ENG,"FW,DF",24.0,6.5,27,13,11,11,5,9,20,45.0,11,13,1,12,3,30,18,0
Fulham,Reiss Nelson,eng ENG,FW,24.0,5.5,8,6,3,3,2,5,13,38.5,8,11,0,11,5,13,2,0
Fulham,Jorge Cuenca,es ESP,DF,24.0,3.9,6,2,5,1,0,3,8,37.5,5,4,4,0,2,8,26,0
Fulham,Tom Cairney,sct SCO,MF,33.0,7.0,13,5,5,2,6,4,7,57.1,3,7,1,6,4,17,3,1
Fulham,Willian,br BRA,FW,35.0,2.9,4,2,0,3,1,2,6,33.3,4,0,0,0,1,5,1,0
Fulham,Joshua King,eng ENG,MF,17.0,1.5,7,5,3,4,0,0,3,0.0,3,3,0,3,1,8,1,0
Fulham,Harrison Reed,eng ENG,MF,29.0,1.2,6,3,3,2,1,1,3,33.3,2,1,0,1,1,7,3,0
Fulham,Martial Godo,eng ENG,"FW,DF",21.0,0.3,0,0,0,0,0,0,0,,0,1,0,1,1,1,0,0
Fulham,Carlos Vinícius,br BRA,MF,29.0,0.2,0,0,0,0,0,0,1,0.0,1,1,0,1,0,0,0,0
Fulham,Jay Stansfield,eng ENG,MF,21.0,0.0,0,0,0,0,0,0,0,,0,0,0,0,0,0,0,0
Crystal Palace,Dean Henderson,eng ENG,GK,27.0,38.0,2,1,2,0,0,2,6,33.3,4,0,0,0,0,2,22,0
Crystal Palace,Daniel Muñoz,co COL,DF,28.0,35.9,123,80,57,41,25,55,96,57.3,41,40,6,34,44,167,108,1
Crystal Palace,Tyrick Mitchell,eng ENG,DF,24.0,34.5,91,55,57,27,7,25,46,54.3,21,68,12,56,19,110,108,2
Crystal Palace,Maxence Lacroix,fr FRA,DF,24.0,34.7,68,41,52,15,1,32,47,68.1,15,48,22,26,54,122,207,2
Crystal Palace,Marc Guéhi,eng ENG,DF,24.0,34.0,61,34,36,23,2,31,47,66.0,16,55,23,32,28,89,162,2
Crystal Palace,Jean-Philippe Mateta,fr FRA,FW,27.0,29.6,18,12,5,11,2,3,16,18.8,13,18,4,14,2,20,23,0
Crystal Palace,Eberechi Eze,eng ENG,MF,26.0,28.9,39,22,14,16,9,17,36,47.2,19,27,0,27,11,50,10,3
Crystal Palace,Ismaila Sarr,sn SEN,MF,26.0,30.3,22,10,10,9,3,8,25,32.0,17,27,8,19,9,31,40,0
Crystal Palace,Jefferson Lerma,co COL,MF,29.0,25.3,35,17,15,16,4,20,37,54.1,17,38,18,20,42,77,80,1
Crystal Palace,Will Hughes,eng ENG,MF,29.0,23.6,66,36,20,33,13,28,62,45.2,34,31,14,17,21,87,28,3
Crystal Palace,Chris Richards,us USA,DF,24.0,21.4,47,30,24,17,6,24,41,58.5,17,40,14,26,19,66,121,0
Crystal Palace,Adam Wharton,eng ENG,MF,20.0,14.8,34,14,14,16,4,17,44,38.6,27,11,2,9,20,54,27,0
Crystal Palace,Daichi Kamada,jp JPN,MF,27.0,17.5,47,29,19,24,4,14,41,34.1,27,22,5,17,18,65,14,0
Crystal Palace,Trevoh Chalobah,eng ENG,DF,25.0,11.8,20,16,7,12,1,12,23,52.2,11,19,9,10,19,39,57,3
Crystal Palace,Eddie Nketiah,eng ENG,FW,25.0,11.6,15,8,7,4,4,6,12,50.0,6,10,1,9,3,18,12,0
Crystal Palace,Nathaniel Clyne,eng ENG,DF,33.0,5.4,12,8,8,3,1,6,11,54.5,5,4,2,2,3,15,14,1
Crystal Palace,Justin Devenny,nir NIR,MF,20.0,5.7,17,12,7,9,1,8,19,42.1,11,6,1,5,0,17,11,0
Crystal Palace,Cheick Doucouré,ml MLI,MF,24.0,5.0,16,8,6,8,2,5,11,45.5,6,4,0,4,11,27,10,1
Crystal Palace,Ben Chilwell,eng ENG,DF,27.0,2.9,7,6,4,3,0,1,5,20.0,4,6,2,4,6,13,16,0
Crystal Palace,Romain Esse,eng ENG,MF,19.0,1.5,8,6,4,2,2,5,5,100.0,0,2,0,2,1,9,2,0
Crystal Palace,Odsonne Édouard,fr FRA,MF,26.0,1.3,1,0,0,1,0,0,2,0.0,2,1,0,1,0,1,1,0
Crystal Palace,Joachim Andersen,dk DEN,DF,28.0,1.0,1,1,1,0,0,1,2,50.0,1,0,0,0,0,1,7,0
Crystal Palace,Chadi Riad,ma MAR,DF,21.0,1.0,5,2,2,2,1,2,3,66.7,1,0,0,0,2,7,0,0
Crystal Palace,Joel Ward,eng ENG,DF,34.0,0.8,2,0,0,2,0,0,0,,0,0,0,0,0,2,3,0
Crystal Palace,Jeffrey Schlupp,gh GHA,MF,31.0,1.1,2,0,1,0,1,0,3,0.0,3,6,0,6,0,2,2,0
Crystal Palace,Matheus França,br BRA,MF,20.0,0.6,2,0,0,2,0,0,0,,0,1,1,0,1,3,1,0
Crystal Palace,Jordan Ayew,gh GHA,FW,32.0,0.2,1,0,0,0,1,0,0,,0,0,0,0,0,1,0,0
Crystal Palace,Caleb Kporha,eng ENG,DF,18.0,0.1,2,1,2,0,0,2,2,100.0,0,0,0,0,0,2,1,0
Crystal Palace,Asher Agbinone,eng ENG,MF,18.0,0.1,2,1,0,2,0,0,0,,0,0,0,0,0,2,0,0
Everton,Jordan Pickford,eng ENG,GK,30.0,38.0,1,0,1,0,0,1,2,50.0,1,0,0,0,1,2,30,2
Everton,Vitaliy Mykolenko,ua UKR,DF,25.0,34.3,63,38,39,14,10,29,56,51.8,27,25,10,15,44,107,145,2
Everton,Idrissa Gana Gueye,sn SEN,MF,34.0,34.1,133,80,61,55,17,58,99,58.6,41,48,9,39,48,181,36,1
Everton,James Tarkowski,eng ENG,DF,31.0,32.5,64,40,39,22,3,24,39,61.5,15,57,42,15,41,105,213,4
Everton,Abdoulaye Doucouré,ml MLI,MF,31.0,28.6,48,28,21,20,7,14,43,32.6,29,31,6,25,10,58,20,1
Everton,Iliman Ndiaye,sn SEN,FW,24.0,27.2,53,28,20,16,17,22,49,44.9,27,30,5,25,20,73,24,1
Everton,Jarrad Branthwaite,eng ENG,DF,22.0,27.9,36,20,26,10,0,20,28,71.4,8,31,23,8,27,63,191,4
Everton,Jack Harrison,eng ENG,FW,27.0,23.2,32,22,12,12,8,15,46,32.6,31,18,2,16,10,42,35,2
Everton,Ashley Young,eng ENG,DF,39.0,20.9,58,33,25,25,8,35,57,61.4,22,14,4,10,25,83,64,2
Everton,Dominic Calvert-Lewin,eng ENG,FW,27.0,18.0,9,7,1,4,4,2,6,33.3,4,7,2,5,7,16,23,0
Everton,James Garner,eng ENG,MF,23.0,17.8,47,31,25,20,2,24,41,58.5,17,20,4,16,23,70,37,0
Everton,Jake O'Brien,ie IRL,DF,23.0,17.5,26,17,21,5,0,17,25,68.0,8,17,4,13,4,30,93,0
Everton,Beto,gw GNB,FW,26.0,17.1,14,6,2,8,4,5,8,62.5,3,12,2,10,4,18,24,1
Everton,Dwight McNeil,eng ENG,MF,24.0,15.3,13,8,6,5,2,9,21,42.9,12,7,0,7,6,19,2,1
Everton,Jesper Lindstrøm,dk DEN,FW,24.0,13.9,45,25,24,19,2,19,55,34.5,36,15,3,12,12,57,17,0
Everton,Orel Mangala,be BEL,MF,26.0,14.0,16,8,3,11,2,5,8,62.5,3,8,3,5,21,37,24,1
Everton,Michael Keane,eng ENG,DF,31.0,11.7,12,9,8,2,2,8,15,53.3,7,14,10,4,16,28,65,2
Everton,Carlos Alcaraz,ar ARG,FW,21.0,8.5,11,5,5,3,3,3,11,27.3,8,9,2,7,5,16,10,0
Everton,Tim Iroegbunam,eng ENG,MF,21.0,6.4,29,14,14,10,5,14,23,60.9,9,18,4,14,16,45,12,1
Everton,Armando Broja,al ALB,FW,22.0,3.8,3,1,1,1,1,0,0,,0,3,0,3,1,4,4,0
Everton,Nathan Patterson,sct SCO,DF,22.0,3.9,11,6,7,4,0,7,14,50.0,7,2,0,2,2,13,7,0
Everton,Séamus Coleman,ie IRL,DF,35.0,2.4,3,2,2,1,0,3,4,75.0,1,5,3,2,1,4,8,0
Everton,Roman Dixon,eng ENG,DF,19.0,1.0,5,5,3,2,0,4,4,100.0,0,1,0,1,1,6,3,0
Everton,Harrison Armstrong,eng ENG,MF,17.0,0.5,0,0,0,0,0,0,1,0.0,1,0,0,0,0,0,1,0
Everton,Youssef Chermiti,pt POR,FW,20.0,0.5,0,0,0,0,0,0,1,0.0,1,0,0,0,0,0,0,0
Everton,Mason Holgate,eng ENG,"FW,DF",27.0,0.1,0,0,0,0,0,0,0,,0,0,0,0,0,0,0,0
West Ham United,Max Kilman,eng ENG,DF,27.0,37.2,39,24,16,20,3,23,27,85.2,4,58,40,18,38,77,212,6
West Ham United,Aaron Wan-Bissaka,eng ENG,DF,26.0,35.1,70,49,33,32,5,23,32,71.9,9,37,11,26,66,136,125,0
West Ham United,Jarrod Bowen,eng ENG,FW,27.0,33.1,41,26,13,12,16,19,40,47.5,21,22,4,18,16,57,25,0
West Ham United,Mohammed Kudus,gh GHA,FW,23.0,28.9,38,23,9,18,11,10,27,37.0,17,24,1,23,4,42,8,2
West Ham United,Tomáš Souček,cz CZE,MF,29.0,28.6,46,21,20,23,3,26,44,59.1,18,41,21,20,20,66,85,1
West Ham United,Lucas Paquetá,br BRA,MF,26.0,26.6,66,37,25,30,11,27,55,49.1,28,29,4,25,18,84,37,6
West Ham United,Emerson Palmieri,it ITA,DF,29.0,23.7,60,31,37,18,5,27,48,56.3,21,32,8,24,21,81,59,0
West Ham United,Alphonse Areola,fr FRA,GK,31.0,25.1,2,2,2,0,0,2,3,66.7,1,0,0,0,0,2,15,3
West Ham United,Konstantinos Mavropanos,gr GRE,DF,26.0,22.7,35,24,24,10,1,16,27,59.3,11,25,18,7,40,75,126,1
West Ham United,Jean-Clair Todibo,fr FRA,DF,24.0,20.4,47,28,30,15,2,26,36,72.2,10,25,13,12,26,73,83,3
West Ham United,Edson Álvarez,mx MEX,MF,26.0,19.8,50,27,27,15,8,17,35,48.6,18,23,8,15,18,68,46,1
West Ham United,Guido Rodríguez,ar ARG,MF,30.0,12.9,36,19,21,15,0,17,33,51.5,16,23,9,14,13,49,35,1
West Ham United,Carlos Soler,es ESP,MF,27.0,15.8,16,11,9,6,1,7,23,30.4,16,19,6,13,8,24,21,2
West Ham United,Łukasz Fabiański,pl POL,GK,39.0,12.9,0,0,0,0,0,0,1,0.0,1,0,0,0,0,0,5,1
West Ham United,James Ward-Prowse,eng ENG,MF,29.0,11.6,20,14,8,8,4,7,19,36.8,12,6,3,3,8,28,15,0
West Ham United,Vladimír Coufal,cz CZE,DF,31.0,11.9,22,15,13,7,2,10,22,45.5,12,13,11,2,8,30,39,1
West Ham United,Michail Antonio,jm JAM,FW,34.0,9.4,2,2,0,1,1,2,3,66.7,1,6,0,6,0,2,2,0
West Ham United,Aaron Cresswell,eng ENG,DF,34.0,9.2,11,7,5,5,1,9,11,81.8,2,9,4,5,8,19,37,0
West Ham United,Crysencio Summerville,nl NED,FW,22.0,8.8,13,7,2,8,3,3,9,33.3,6,13,4,9,0,13,7,0
West Ham United,Oliver Scarles,eng ENG,DF,18.0,7.4,21,11,17,3,1,14,22,63.6,8,14,2,12,11,32,26,0
West Ham United,Niclas Füllkrug,de GER,FW,31.0,8.8,4,3,0,1,3,3,4,75.0,1,1,0,1,1,5,16,0
West Ham United,Danny Ings,eng ENG,FW,32.0,3.2,4,2,2,2,0,1,3,33.3,2,5,0,5,1,5,4,0
West Ham United,Andy Irving,sct SCO,MF,24.0,1.9,7,4,3,3,1,1,5,20.0,4,5,1,4,1,8,5,0
West Ham United,Evan Ferguson,ie IRL,FW,19.0,1.7,3,1,0,1,2,0,0,,0,2,1,1,1,4,1,0
West Ham United,Luis Guilherme,br BRA,MF,18.0,1.7,1,0,1,0,0,0,3,0.0,3,7,0,7,3,4,2,0
West Ham United,Lewis Orford,eng ENG,MF,18.0,0.5,0,0,0,0,0,0,0,,0,1,0,1,1,1,0,0
West Ham United,Kaelan Casey,eng ENG,DF,19.0,0.0,0,0,0,0,0,0,0,,0,0,0,0,0,0,1,0
Manchester United,Bruno Fernandes,pt POR,MF,29.0,33.6,84,50,27,38,19,34,85,40.0,51,35,6,29,26,110,35,3
Manchester United,André Onana,cm CMR,GK,28.0,34.0,2,2,2,0,0,2,4,50.0,2,0,0,0,0,2,11,4
Manchester United,Noussair Mazraoui,ma MAR,DF,26.0,31.7,115,68,58,42,15,59,94,62.8,35,36,9,27,34,149,95,1
Manchester United,Diogo Dalot,pt POR,DF,25.0,31.3,68,40,40,22,6,34,52,65.4,18,22,9,13,37,105,72,0
Manchester United,Matthijs de Ligt,nl NED,DF,24.0,23.7,30,22,17,12,1,23,32,71.9,9,29,21,8,33,63,96,0
Manchester United,Alejandro Garnacho,ar ARG,MF,20.0,24.5,30,18,11,6,13,12,37,32.4,25,19,0,19,13,43,11,2
Manchester United,Rasmus Højlund,dk DEN,FW,21.0,22.4,3,1,0,2,1,0,5,0.0,5,6,0,6,2,5,6,0
Manchester United,Manuel Ugarte Ribeiro,uy URU,MF,23.0,20.0,77,49,34,34,9,30,68,44.1,38,33,4,29,27,104,17,2
Manchester United,Amad Diallo,ci CIV,MF,22.0,21.2,38,31,9,20,9,19,32,59.4,13,15,2,13,11,49,19,1
Manchester United,Lisandro Martínez,ar ARG,DF,26.0,19.5,40,24,25,12,3,21,36,58.3,15,22,8,14,32,72,57,1
Manchester United,Harry Maguire,eng ENG,DF,31.0,19.6,30,15,23,6,1,17,23,73.9,6,15,12,3,40,70,78,1
Manchester United,Kobbie Mainoo,eng ENG,MF,19.0,18.5,46,29,18,14,14,24,40,60.0,16,16,2,14,19,65,14,1
Manchester United,Casemiro,br BRA,MF,32.0,16.7,83,50,50,23,10,45,74,60.8,29,39,10,29,14,97,51,3
Manchester United,Joshua Zirkzee,nl NED,FW,23.0,15.7,14,8,3,8,3,5,10,50.0,5,15,4,11,6,20,8,1
Manchester United,Leny Yoro,fr FRA,DF,18.0,13.0,29,11,19,9,1,13,19,68.4,6,5,3,2,18,47,43,0
Manchester United,Marcus Rashford,eng ENG,FW,26.0,11.0,7,4,2,2,3,3,9,33.3,6,8,0,8,4,11,7,0
Manchester United,Christian Eriksen,dk DEN,MF,32.0,11.9,19,9,4,12,3,11,27,40.7,16,15,5,10,7,26,8,0
Manchester United,Patrick Dorgu,dk DEN,DF,19.0,9.4,31,24,15,14,2,16,23,69.6,7,11,0,11,4,35,23,2
Manchester United,Mason Mount,eng ENG,MF,25.0,7.0,15,5,5,8,2,9,12,75.0,3,11,1,10,4,19,4,0
Manchester United,Victor Lindelöf,se SWE,DF,30.0,7.8,7,2,5,1,1,3,4,75.0,1,6,4,2,8,15,36,2
Manchester United,Altay Bayındır,tr TUR,GK,26.0,4.0,0,0,0,0,0,0,1,0.0,1,0,0,0,0,0,9,1
Manchester United,Luke Shaw,eng ENG,DF,29.0,3.9,4,3,2,2,0,2,2,100.0,0,6,1,5,2,6,7,0
Manchester United,Harry Amass,eng ENG,DF,17.0,3.9,6,2,5,1,0,2,8,25.0,6,11,1,10,2,8,11,0
Manchester United,Jonny Evans,nir NIR,DF,36.0,3.5,8,6,4,4,0,3,6,50.0,3,3,2,1,5,13,15,0
Manchester United,Ayden Heaven,eng ENG,DF,17.0,1.9,4,3,1,3,0,2,2,100.0,0,2,2,0,4,8,9,0
Manchester United,Tyler Fredricson,eng ENG,DF,19.0,1.8,5,3,3,2,0,1,2,50.0,1,2,0,2,1,6,11,0
Manchester United,Tyrell Malacia,nl NED,DF,24.0,1.1,2,1,2,0,0,1,2,50.0,1,0,0,0,1,3,1,1
Manchester United,Chidozie Obi-Martin,dk DEN,FW,16.0,1.8,2,1,0,0,2,2,2,100.0,0,0,0,0,0,2,1,0
Manchester United,Toby Collyer,eng ENG,MF,20.0,2.0,12,9,6,6,0,5,6,83.3,1,2,1,1,2,14,3,0
Manchester United,Antony,br BRA,DF,24.0,1.6,6,3,4,2,0,2,5,40.0,3,2,0,2,2,8,0,0
Manchester United,Scott McTominay,sct SCO,MF,27.0,0.2,0,0,0,0,0,0,1,0.0,1,0,0,0,0,0,1,0
Wolverhampton Wanderers,Rayan Aït-Nouri,dz ALG,DF,23.0,34.7,89,57,52,28,9,43,70,61.4,27,42,6,36,26,115,75,2
Wolverhampton Wanderers,João Gomes,br BRA,MF,23.0,33.2,116,71,55,53,8,48,110,43.6,62,42,4,38,25,141,33,0
Wolverhampton Wanderers,Nélson Semedo,pt POR,DF,30.0,32.2,62,36,32,21,9,34,57,59.6,23,32,10,22,23,85,104,3
Wolverhampton Wanderers,André,br BRA,MF,23.0,27.6,91,55,41,41,9,37,63,58.7,26,42,8,34,37,128,30,1
Wolverhampton Wanderers,Toti Gomes,pt POR,DF,25.0,29.1,61,43,42,15,4,37,46,80.4,9,29,17,12,25,86,152,5
Wolverhampton Wanderers,Jørgen Strand Larsen,no NOR,FW,24.0,29.0,10,6,2,3,5,4,27,14.8,23,19,4,15,6,16,29,0
Wolverhampton Wanderers,José Sá,pt POR,GK,31.0,29.0,2,2,2,0,0,2,2,100.0,0,0,0,0,0,2,15,1
Wolverhampton Wanderers,Matheus Cunha,br BRA,MF,25.0,29.0,38,22,17,16,5,13,39,33.3,26,21,1,20,17,55,23,0
Wolverhampton Wanderers,Matt Doherty,ie IRL,DF,32.0,23.5,38,21,25,13,0,17,25,68.0,8,28,15,13,22,60,102,3
Wolverhampton Wanderers,Jean-Ricner Bellegarde,fr FRA,MF,26.0,18.8,39,24,17,19,3,14,20,70.0,6,19,3,16,10,49,18,1
Wolverhampton Wanderers,Santiago Bueno,uy URU,DF,25.0,18.8,41,21,22,18,1,17,22,77.3,5,36,21,15,15,56,70,0
Wolverhampton Wanderers,Emmanuel Agbadou,ci CIV,DF,27.0,15.7,30,19,21,9,0,13,20,65.0,7,19,13,6,12,42,90,0
Wolverhampton Wanderers,Mario Lemina,ga GAB,MF,30.0,15.2,51,31,27,19,5,20,29,69.0,9,12,7,5,27,78,50,3
Wolverhampton Wanderers,Marshall Munetsi,zw ZIM,MF,28.0,12.0,24,10,7,11,6,13,23,56.5,10,14,1,13,6,30,18,0
Wolverhampton Wanderers,Gonçalo Guedes,pt POR,MF,27.0,11.1,16,5,2,6,8,4,16,25.0,12,11,0,11,5,21,4,0
Wolverhampton Wanderers,Craig Dawson,eng ENG,DF,34.0,10.8,15,3,8,6,1,12,15,80.0,3,16,11,5,9,24,52,1
Wolverhampton Wanderers,Pablo Sarabia,es ESP,MF,32.0,9.1,16,8,4,8,4,10,16,62.5,6,10,0,10,4,20,7,1
Wolverhampton Wanderers,Rodrigo Gomes,pt POR,DF,21.0,9.1,23,15,14,9,0,12,21,57.1,9,8,1,7,7,30,20,1
Wolverhampton Wanderers,Sam Johnstone,eng ENG,GK,31.0,7.0,0,0,0,0,0,0,1,0.0,1,0,0,0,0,0,7,0
Wolverhampton Wanderers,Hwang Hee-chan,kr KOR,MF,28.0,7.4,6,4,2,1,3,2,6,33.3,4,9,0,9,2,8,11,0
Wolverhampton Wanderers,Yerson Mosquera,co COL,DF,23.0,4.9,11,7,9,2,0,9,14,64.3,5,13,10,3,10,21,14,0
Wolverhampton Wanderers,Tommy Doyle,eng ENG,MF,22.0,5.4,11,6,6,3,2,6,15,40.0,9,11,5,6,5,16,11,1
Wolverhampton Wanderers,Daniel Bentley,eng ENG,GK,31.0,2.0,0,0,0,0,0,0,0,,0,0,0,0,0,0,1,0
Wolverhampton Wanderers,Carlos Forbs,pt POR,MF,20.0,2.7,8,5,5,2,1,4,6,66.7,2,3,0,3,1,9,2,1
Wolverhampton Wanderers,Pedro Lima,br BRA,DF,18.0,0.8,1,0,0,0,1,1,3,33.3,2,0,0,0,2,3,5,0
Wolverhampton Wanderers,Nasser Djiga,bf BFA,DF,21.0,0.7,0,0,0,0,0,0,1,0.0,1,0,0,0,2,2,4,1
Wolverhampton Wanderers,Daniel Podence,pt POR,MF,28.0,0.5,0,0,0,0,0,0,1,0.0,1,0,0,0,0,0,0,0
Wolverhampton Wanderers,Chiquinho,pt POR,MF,24.0,0.1,0,0,0,0,0,0,0,,0,0,0,0,0,0,0,0
Wolverhampton Wanderers,Mateus Mane,,MF,nan,0.0,0,0,0,0,0,0,0,,0,1,0,1,0,0,0,0
Wolverhampton Wanderers,Tom King,wls WAL,GK,29.0,0.0,0,0,0,0,0,0,0,,0,0,0,0,0,0,0,0
Wolverhampton Wanderers,Alfie Pond,eng ENG,DF,20.0,0.0,0,0,0,0,0,0,0,,0,0,0,0,0,0,0,0
Wolverhampton Wanderers,Boubacar Traoré,ml MLI,MF,22.0,0.0,2,0,0,2,0,1,1,100.0,0,0,0,0,0,2,0,0
Tottenham Hotspur,Pedro Porro,es ESP,DF,24.0,29.0,66,49,34,22,10,44,77,57.1,33,44,17,27,36,102,84,2
Tottenham Hotspur,Dejan Kulusevski,se SWE,MF,24.0,26.6,45,23,17,13,15,19,51,37.3,32,34,5,29,13,58,10,1
Tottenham Hotspur,Dominic Solanke,eng ENG,FW,26.0,24.5,18,11,1,12,5,4,16,25.0,12,20,9,11,1,19,23,0
Tottenham Hotspur,Brennan Johnson,wls WAL,FW,23.0,24.3,39,26,9,20,10,16,34,47.1,18,25,3,22,4,43,14,0
Tottenham Hotspur,Guglielmo Vicario,it ITA,GK,27.0,24.0,0,0,0,0,0,0,0,,0,0,0,0,1,1,14,6
Tottenham Hotspur,Son Heung-min,kr KOR,FW,32.0,23.6,17,9,3,8,6,5,27,18.5,22,11,0,11,5,22,17,1
Tottenham Hotspur,Destiny Udogie,it ITA,DF,21.0,21.5,75,47,42,26,7,33,48,68.8,15,40,6,34,22,97,36,1
Tottenham Hotspur,Pape Matar Sarr,sn SEN,MF,21.0,21.4,49,36,19,23,7,12,24,50.0,12,26,10,16,30,79,25,1
Tottenham Hotspur,James Maddison,eng ENG,MF,27.0,20.3,31,19,8,16,7,9,29,31.0,20,15,4,11,12,43,19,1
Tottenham Hotspur,Rodrigo Bentancur,uy URU,MF,27.0,18.4,40,22,19,17,4,19,40,47.5,21,25,8,17,40,80,38,1
Tottenham Hotspur,Djed Spence,eng ENG,DF,23.0,19.9,47,34,25,15,7,23,30,76.7,7,28,9,19,21,68,74,2
Tottenham Hotspur,Archie Gray,eng ENG,DF,18.0,19.5,16,8,4,8,4,7,17,41.2,10,22,11,11,19,35,50,2
Tottenham Hotspur,Cristian Romero,ar ARG,DF,26.0,15.8,35,29,26,8,1,21,30,70.0,9,18,3,15,21,56,57,2
Tottenham Hotspur,Yves Bissouma,ml MLI,MF,27.0,15.7,49,31,20,25,4,19,34,55.9,15,11,6,5,18,67,40,4
Tottenham Hotspur,Ben Davies,wls WAL,DF,31.0,14.8,17,11,8,8,1,9,17,52.9,8,28,19,9,12,29,81,1
Tottenham Hotspur,Radu Drăgușin,ro ROU,DF,22.0,13.9,10,6,8,2,0,6,12,50.0,6,22,16,6,15,25,49,4
Tottenham Hotspur,Micky van de Ven,nl NED,DF,23.0,11.3,10,6,5,4,1,8,14,57.1,6,12,8,4,10,20,39,1
Tottenham Hotspur,Lucas Bergvall,se SWE,MF,18.0,13.5,39,19,14,20,5,17,32,53.1,15,18,8,10,24,63,22,3
Tottenham Hotspur,Mathys Tel,fr FRA,FW,19.0,10.2,16,6,4,7,5,5,13,38.5,8,8,1,7,2,18,8,2
Tottenham Hotspur,Wilson Odobert,fr FRA,FW,19.0,9.5,14,5,5,4,5,8,14,57.1,6,6,0,6,4,18,5,1
Tottenham Hotspur,Kevin Danso,at AUT,DF,25.0,9.4,7,5,4,3,0,6,11,54.5,5,15,14,1,6,13,71,1
Tottenham Hotspur,Fraser Forster,eng ENG,GK,36.0,7.0,0,0,0,0,0,0,1,0.0,1,0,0,0,0,0,7,3
Tottenham Hotspur,Antonín Kinský,cz CZE,GK,21.0,6.0,3,1,3,0,0,1,1,100.0,0,0,0,0,0,3,9,1
Tottenham Hotspur,Timo Werner,de GER,FW,28.0,5.8,6,4,3,3,0,3,13,23.1,10,10,1,9,1,7,7,0
Tottenham Hotspur,Richarlison,br BRA,FW,27.0,5.6,5,3,0,4,1,0,3,0.0,3,1,1,0,0,5,8,0
Tottenham Hotspur,Mikey Moore,eng ENG,FW,16.0,4.1,2,1,2,0,0,0,4,0.0,4,2,0,2,1,3,5,0
Tottenham Hotspur,Sergio Reguilón,es ESP,DF,27.0,2.2,4,3,1,3,0,2,5,40.0,3,7,0,7,4,8,8,0
Tottenham Hotspur,Brandon Austin,eng ENG,GK,25.0,1.0,0,0,0,0,0,0,0,,0,0,0,0,0,0,1,0
Tottenham Hotspur,Dane Scarlett,eng ENG,FW,20.0,0.4,1,0,0,1,0,0,0,,0,0,0,0,0,1,1,0
Tottenham Hotspur,Alfie Dorrington,eng ENG,DF,19.0,0.2,0,0,0,0,0,0,0,,0,0,0,0,0,0,0,0
Tottenham Hotspur,Will Lankshear,eng ENG,FW,19.0,0.1,0,0,0,0,0,0,0,,0,0,0,0,0,0,0,0
Leicester City,Jamie Vardy,eng ENG,FW,37.0,31.5,19,13,7,7,5,4,13,30.8,9,8,4,4,5,24,24,0
Leicester City,James Justin,eng ENG,DF,26.0,32.5,58,37,29,23,6,32,55,58.2,23,48,17,31,46,104,141,3
Leicester City,Wout Faes,be BEL,DF,26.0,31.3,42,26,26,14,2,25,48,52.1,23,48,35,13,26,68,185,4
Leicester City,Victor Bernth Kristiansen,dk DEN,DF,21.0,27.7,87,51,56,26,5,49,91,53.8,42,38,15,23,42,129,75,3
Leicester City,Wilfred Ndidi,ng NGA,MF,27.0,26.0,85,51,45,32,8,30,61,49.2,31,47,19,28,31,116,80,0
Leicester City,Mads Hermansen,dk DEN,GK,24.0,26.5,1,1,1,0,0,1,1,100.0,0,1,0,1,0,1,13,4
Leicester City,Bilal El Khannouss,ma MAR,MF,20.0,24.5,50,30,16,29,5,17,32,53.1,15,22,4,18,6,56,10,3
Leicester City,Boubakary Soumaré,fr FRA,MF,25.0,24.2,37,20,24,12,1,21,33,63.6,12,22,10,12,27,64,34,4
Leicester City,Conor Coady,eng ENG,DF,31.0,19.1,13,9,6,6,1,3,6,50.0,3,32,24,8,13,26,71,2
Leicester City,Jordan Ayew,gh GHA,FW,32.0,18.4,27,15,8,14,5,7,23,30.4,16,21,2,19,12,39,19,0
Leicester City,Harry Winks,eng ENG,MF,28.0,17.1,24,11,12,10,2,13,30,43.3,17,19,7,12,9,33,20,0
Leicester City,Stephy Mavididi,eng ENG,FW,26.0,18.1,34,19,16,10,8,14,42,33.3,28,26,2,24,11,45,15,0
Leicester City,Jannik Vestergaard,dk DEN,DF,31.0,15.5,22,10,16,6,0,9,15,60.0,6,21,14,7,16,38,74,1
Leicester City,Facundo Buonanotte,ar ARG,FW,19.0,17.0,53,32,17,22,14,21,67,31.3,46,34,6,28,12,65,14,0
Leicester City,Luke Thomas,eng ENG,DF,23.0,12.4,31,25,23,5,3,21,41,51.2,20,15,6,9,21,52,49,1
Leicester City,Caleb Okoli,it ITA,DF,23.0,12.5,25,14,8,15,2,11,18,61.1,7,24,14,10,15,40,79,3
Leicester City,Oliver Skipp,eng ENG,MF,23.0,12.6,21,4,6,12,3,9,15,60.0,6,23,7,16,11,32,11,2
Leicester City,Jakub Stolarczyk,pl POL,GK,23.0,10.0,2,1,2,0,0,1,2,50.0,1,0,0,0,0,2,6,1
Leicester City,Kasey McAteer,ie IRL,FW,22.0,9.6,23,16,11,9,3,14,29,48.3,15,18,2,16,5,28,15,0
Leicester City,Bobby De Cordova-Reid,jm JAM,FW,31.0,8.4,9,4,3,6,0,4,14,28.6,10,6,1,5,0,9,10,0
Leicester City,Patson Daka,zm ZAM,FW,25.0,8.2,19,10,6,9,4,7,18,38.9,11,7,1,6,1,20,12,0
Leicester City,Abdul Fatawu Issahaku,gh GHA,FW,20.0,6.4,21,15,13,2,6,11,19,57.9,8,7,0,7,4,25,12,0
Leicester City,Ricardo Pereira,pt POR,DF,30.0,4.3,13,8,4,6,3,7,14,50.0,7,8,3,5,4,17,11,0
Leicester City,Danny Ward,wls WAL,GK,31.0,1.5,0,0,0,0,0,0,0,,0,0,0,0,0,0,1,0
Leicester City,Hamza Choudhury,bd BAN,MF,26.0,1.5,1,1,1,0,0,1,3,33.3,2,4,2,2,5,6,2,0
Leicester City,Woyo Coulibaly,ml MLI,DF,25.0,1.2,6,4,4,2,0,2,2,100.0,0,3,1,2,5,11,1,0
Leicester City,Jeremy Monga,,FW,nan,1.2,2,1,0,1,1,1,1,100.0,0,3,2,1,0,2,1,0
Leicester City,Odsonne Édouard,fr FRA,FW,26.0,0.3,1,1,1,0,0,0,0,,0,0,0,0,0,1,1,0
Leicester City,Jake Evans,,FW,nan,0.3,1,1,0,0,1,0,1,0.0,1,0,0,0,0,1,1,0
Leicester City,Olabade Aluko,,DF,nan,0.0,1,1,0,0,1,1,1,100.0,0,0,0,0,0,1,0,0
Leicester City,Will Alves,eng ENG,FW,19.0,0.0,0,0,0,0,0,0,0,,0,0,0,0,0,0,0,0
Leicester City,Michael Golding,eng ENG,MF,18.0,0.0,0,0,0,0,0,0,0,,0,0,0,0,0,0,0,0
Ipswich Town,Dara O'Shea,ie IRL,DF,25.0,34.7,49,31,33,13,3,22,34,64.7,12,62,50,12,33,82,225,4
Ipswich Town,Leif Davis,eng ENG,DF,24.0,30.5,46,27,33,9,4,30,48,62.5,18,25,8,17,25,71,77,3
Ipswich Town,Liam Delap,eng ENG,FW,21.0,29.1,11,8,3,3,5,2,15,13.3,13,8,0,8,2,13,28,0
Ipswich Town,Sam Morsy,eg EGY,MF,32.0,30.7,68,41,40,24,4,27,62,43.5,35,34,13,21,29,97,47,5
Ipswich Town,Omari Hutchinson,eng ENG,MF,20.0,28.8,32,13,14,10,8,13,48,27.1,35,27,2,25,11,43,15,1
Ipswich Town,Jacob Greaves,eng ENG,DF,23.0,24.5,40,21,20,17,3,22,35,62.9,13,41,26,15,21,61,148,3
Ipswich Town,Jens Cajuste,se SWE,MF,24.0,22.0,44,22,19,23,2,21,49,42.9,28,25,10,15,28,72,33,2
Ipswich Town,Axel Tuanzebe,cd COD,DF,26.0,19.1,31,19,21,4,6,17,26,65.4,9,21,10,11,23,54,56,1
Ipswich Town,Arijanet Muric,xk KVX,GK,25.0,18.0,0,0,0,0,0,0,2,0.0,2,0,0,0,0,0,10,5
Ipswich Town,Cameron Burgess,au AUS,DF,28.0,17.1,17,12,14,3,0,9,11,81.8,2,20,15,5,14,31,128,3
Ipswich Town,Ben Johnson,eng ENG,DF,24.0,15.1,38,22,23,12,3,20,41,48.8,21,22,5,17,13,51,54,1
Ipswich Town,Kalvin Phillips,eng ENG,MF,28.0,13.8,35,19,8,20,7,15,39,38.5,24,35,6,29,19,54,37,2
Ipswich Town,Alex Palmer,eng ENG,GK,27.0,13.0,0,0,0,0,0,0,0,,0,0,0,0,0,0,12,0
Ipswich Town,Sammie Szmodics,ie IRL,FW,28.0,11.2,16,10,4,10,2,7,26,26.9,19,10,2,8,6,22,14,0
Ipswich Town,Jack Clarke,eng ENG,FW,23.0,13.2,32,20,11,10,11,17,34,50.0,17,9,0,9,7,39,29,2
Ipswich Town,Luke Woolfenden,eng ENG,DF,25.0,13.2,9,6,5,4,0,2,5,40.0,3,21,14,7,19,28,76,0
Ipswich Town,Wes Burns,wls WAL,"FW,DF",29.0,10.4,13,11,1,9,3,4,10,40.0,6,7,2,5,10,23,13,2
Ipswich Town,Julio Enciso,py PAR,MF,20.0,9.8,12,9,3,6,3,4,11,36.4,7,8,1,7,1,13,6,0
Ipswich Town,Conor Chaplin,eng ENG,MF,27.0,9.6,15,5,6,6,3,6,14,42.9,8,8,1,7,4,19,3,0
Ipswich Town,Nathan Broadhead,wls WAL,MF,26.0,7.9,9,4,3,6,0,3,12,25.0,9,8,1,7,4,13,5,0
Ipswich Town,Christian Walton,eng ENG,GK,28.0,7.0,0,0,0,0,0,0,1,0.0,1,0,0,0,0,0,2,1
Ipswich Town,George Hirst,sct SCO,FW,25.0,7.4,3,3,1,0,2,1,4,25.0,3,1,1,0,2,5,10,0
Ipswich Town,Jaden Philogene Bidace,eng ENG,"FW,DF",22.0,5.3,14,7,6,6,2,8,15,53.3,7,11,1,10,10,24,9,1
Ipswich Town,Jack Taylor,ie IRL,MF,26.0,9.6,20,10,6,11,3,12,27,44.4,15,12,3,9,9,29,24,0
Ipswich Town,Harry Clarke,eng ENG,DF,23.0,4.2,5,3,3,2,0,3,6,50.0,3,5,4,1,4,9,14,3
Ipswich Town,Conor Townsend,eng ENG,DF,31.0,3.7,11,8,9,2,0,8,11,72.7,3,8,6,2,4,15,16,0
Ipswich Town,Chiedozie Ogbene,ie IRL,FW,27.0,2.7,7,3,1,2,4,2,4,50.0,2,1,0,1,1,8,3,0
Ipswich Town,Massimo Luongo,au AUS,MF,31.0,2.3,9,6,6,2,1,5,8,62.5,3,4,2,2,2,11,2,0
Ipswich Town,Ben Godfrey,eng ENG,DF,26.0,1.8,1,0,1,0,0,1,1,100.0,0,1,1,0,2,3,3,0
Ipswich Town,Ali Al Hamadi,iq IRQ,FW,22.0,1.5,1,0,0,0,1,0,2,0.0,2,0,0,0,0,1,2,0
Ipswich Town,Marcus Harness,eng ENG,MF,28.0,0.5,1,0,0,0,1,0,3,0.0,3,2,1,1,0,1,1,0
Ipswich Town,George Edmundson,eng ENG,DF,26.0,0.0,0,0,0,0,0,0,0,,0,0,0,0,0,0,0,0
Southampton,Mateus Fernandes,pt POR,MF,20.0,32.5,89,48,45,28,16,33,72,45.8,39,43,8,35,28,117,35,7
Southampton,Kyle Walker-Peters,eng ENG,DF,27.0,32.5,44,29,22,15,7,16,35,45.7,19,27,15,12,19,63,90,1
Southampton,Taylor Harwood-Bellis,eng ENG,DF,22.0,31.4,28,20,13,12,3,19,35,54.3,16,65,43,22,30,58,141,6
Southampton,Aaron Ramsdale,eng ENG,GK,26.0,30.0,0,0,0,0,0,0,3,0.0,3,0,0,0,2,2,10,3
Southampton,Jan Bednarek,pl POL,DF,28.0,28.2,36,19,23,13,0,16,31,51.6,15,47,36,11,56,92,190,5
Southampton,Flynn Downes,eng ENG,MF,25.0,24.0,49,25,23,21,5,15,36,41.7,21,28,9,19,32,81,51,4
Southampton,Joe Aribo,ng NGA,MF,28.0,22.5,47,33,17,24,6,17,35,48.6,18,28,11,17,20,67,32,3
Southampton,Tyler Dibling,eng ENG,FW,18.0,20.9,34,20,13,18,3,16,26,61.5,10,19,5,14,8,42,16,1
Southampton,Lesley Ugochukwu,fr FRA,MF,20.0,18.5,50,24,16,30,4,18,36,50.0,18,27,10,17,14,64,23,2
Southampton,Ryan Manning,ie IRL,DF,28.0,16.4,28,17,16,10,2,14,26,53.8,12,20,11,9,17,45,47,0
Southampton,Kamaldeen Sulemana,gh GHA,FW,22.0,15.7,22,17,9,5,8,10,15,66.7,5,16,4,12,6,28,9,0
Southampton,Jack Stephens,eng ENG,DF,30.0,15.5,34,20,25,9,0,17,30,56.7,13,20,13,7,13,47,53,2
Southampton,Yukinari Sugawara,jp JPN,DF,24.0,17.4,31,18,16,14,1,19,31,61.3,12,21,10,11,11,42,53,3
Southampton,Adam Armstrong,eng ENG,FW,27.0,14.0,12,3,2,7,3,3,14,21.4,11,6,1,5,3,15,8,0
Southampton,Cameron Archer,eng ENG,FW,23.0,16.2,13,8,8,3,2,2,9,22.2,7,5,1,4,2,15,11,0
Southampton,James Bree,eng ENG,DF,26.0,12.0,19,14,8,10,1,10,25,40.0,15,10,3,7,9,28,29,0
Southampton,Paul Onuachu,ng NGA,FW,30.0,11.7,7,2,1,5,1,3,7,42.9,4,7,2,5,1,8,16,1
Southampton,Nathan Wood-Gordon,eng ENG,DF,22.0,8.6,14,8,8,5,1,8,11,72.7,3,9,6,3,5,19,39,2
Southampton,William Smallbone,ie IRL,MF,24.0,7.7,20,13,9,9,2,7,22,31.8,15,8,0,8,2,22,14,2
Southampton,Welington,br BRA,DF,23.0,5.4,21,9,15,5,1,12,19,63.2,7,5,1,4,7,28,36,0
Southampton,Alex McCarthy,eng ENG,GK,34.0,5.0,0,0,0,0,0,0,0,,0,0,0,0,0,0,1,4
Southampton,Adam Lallana,eng ENG,MF,36.0,4.1,8,5,4,4,0,2,12,16.7,10,4,1,3,5,13,5,0
Southampton,Ben Brereton,cl CHI,FW,25.0,5.0,3,2,0,2,1,1,9,11.1,8,2,1,1,0,3,4,0
Southampton,Ross Stewart,sct SCO,FW,28.0,4.4,6,4,1,1,4,3,8,37.5,5,3,0,3,1,7,7,0
Southampton,Ryan Fraser,sct SCO,"FW,DF",30.0,3.4,6,2,2,4,0,4,6,66.7,2,1,1,0,1,7,9,0
Southampton,Charlie Taylor,eng ENG,DF,30.0,4.0,7,5,4,3,0,5,7,71.4,2,8,5,3,5,12,31,1
Southampton,Joe Lumley,eng ENG,GK,29.0,3.0,0,0,0,0,0,0,0,,0,0,0,0,0,0,3,3
Southampton,Armel Bella Kotchap,de GER,DF,22.0,3.7,7,5,5,2,0,3,6,50.0,3,2,2,0,5,12,21,1
Southampton,Albert Grønbaek,dk DEN,FW,23.0,1.6,4,1,1,1,2,3,10,30.0,7,1,1,0,0,4,1,0
Southampton,Jay Robinson,eng ENG,MF,17.0,1.5,4,1,3,0,1,1,1,100.0,0,0,0,0,0,4,1,0
Southampton,Maxwel Cornet,ci CIV,FW,27.0,0.8,5,5,1,4,0,0,4,0.0,4,0,0,0,0,5,2,0
Southampton,Samuel Edozie,eng ENG,DF,21.0,0.7,3,1,0,1,2,2,2,100.0,0,0,0,0,0,3,0,0
Southampton,Samuel Amo-Ameyaw,eng ENG,"FW,DF",18.0,0.3,1,0,0,1,0,1,1,100.0,0,0,0,0,0,1,0,0
Southampton,Joachim Kayi Sanda,fr FRA,DF,17.0,0.2,0,0,0,0,0,0,0,,0,0,0,0,2,2,0,0
Southampton,Ronnie Edwards,eng ENG,DF,21.0,0.1,0,0,0,0,0,0,0,,0,1,1,0,0,0,0,0
Southampton,Carlos Alcaraz,ar ARG,MF,21.0,0.1,0,0,0,0,0,0,0,,0,0,0,0,1,1,0,0
Barcelona,Pedri,es ESP,MF,21.0,32.2,61,34,14,38,9,24,70,34.3,46,45,3,42,26,87,21,1
Barcelona,Raphinha,br BRA,FW,27.0,31.6,36,22,6,19,11,19,39,48.7,20,29,2,27,11,47,26,0
Barcelona,Robert Lewandowski,pl POL,FW,35.0,29.8,10,5,1,5,4,5,11,45.5,6,14,2,12,3,13,26,0
Barcelona,Lamine Yamal,es ESP,FW,17.0,31.9,42,28,8,17,17,16,38,42.1,22,12,0,12,16,58,3,0
Barcelona,Pau Cubarsí,es ESP,DF,17.0,29.2,34,23,21,10,3,19,30,63.3,11,12,9,3,16,50,86,1
Barcelona,Jules Koundé,fr FRA,DF,25.0,29.0,63,43,29,23,11,44,66,66.7,22,35,5,30,20,83,68,2
Barcelona,Iñigo Martínez,es ESP,DF,33.0,27.7,25,14,20,5,0,16,22,72.7,6,18,7,11,18,43,108,1
Barcelona,Alejandro Balde,es ESP,DF,20.0,25.5,18,10,10,5,3,11,17,64.7,6,24,5,19,5,23,27,0
Barcelona,Marc Casado,es ESP,MF,20.0,18.0,44,25,7,30,7,20,41,48.8,21,20,5,15,22,66,22,1
Barcelona,Iñaki Peña,es ESP,GK,25.0,15.5,0,0,0,0,0,0,2,0.0,2,0,0,0,0,0,20,1
Barcelona,Wojciech Szczęsny,pl POL,GK,34.0,15.0,1,1,1,0,0,0,0,,0,0,0,0,0,1,20,1
Barcelona,Eric García,es ESP,DF,23.0,17.5,38,21,11,24,3,20,29,69.0,9,24,8,16,14,52,41,0
Barcelona,Gavi,es ESP,MF,19.0,12.2,30,21,10,15,5,15,26,57.7,11,14,1,13,10,40,7,0
Barcelona,Dani Olmo,es ESP,MF,26.0,13.6,16,11,8,5,3,4,14,28.6,10,6,3,3,3,19,11,1
Barcelona,Fermin López,es ESP,MF,21.0,14.0,19,15,3,9,7,8,32,25.0,24,11,0,11,5,24,3,0
Barcelona,Ferrán Torres,es ESP,FW,24.0,12.4,8,4,2,3,3,3,8,37.5,5,7,1,6,4,12,5,0
Barcelona,Gerard Martín,es ESP,DF,22.0,11.6,22,10,10,7,5,11,16,68.8,5,16,2,14,13,35,27,0
Barcelona,Ronald Araújo,uy URU,DF,25.0,8.4,12,9,6,5,1,4,5,80.0,1,6,4,2,9,21,25,0
Barcelona,Frenkie de Jong,nl NED,MF,27.0,12.7,19,11,5,8,6,8,16,50.0,8,9,1,8,12,31,7,1
Barcelona,Marc-André ter Stegen,de GER,GK,32.0,7.5,0,0,0,0,0,0,1,0.0,1,0,0,0,0,0,2,2
Barcelona,Héctor Fort,es ESP,DF,17.0,6.5,13,8,6,4,3,10,16,62.5,6,12,0,12,6,19,16,0
Barcelona,Pablo Torre,es ESP,MF,21.0,3.5,5,4,1,3,1,2,4,50.0,2,0,0,0,3,8,5,1
Barcelona,Marc Bernal,es ESP,MF,17.0,2.7,8,6,2,5,1,7,8,87.5,1,5,1,4,1,9,4,0
Barcelona,Ansu Fati,es ESP,FW,21.0,2.6,4,1,0,2,2,1,2,50.0,1,1,0,1,1,5,0,1
Barcelona,Pau Victor,es ESP,FW,22.0,3.6,3,1,0,2,1,0,3,0.0,3,6,1,5,2,5,5,0
Barcelona,Andreas Christensen,dk DEN,DF,28.0,2.8,6,4,4,1,1,4,4,100.0,0,2,0,2,4,10,9,0
Barcelona,Sergi Dominguez,es ESP,DF,19.0,1.9,1,1,1,0,0,0,0,,0,0,0,0,3,4,7,0
Barcelona,Daniel Rodriguez,es ESP,FW,18.0,0.4,0,0,0,0,0,0,0,,0,1,0,1,0,0,0,0
Real Madrid,Federico Valverde,uy URU,MF,26.0,33.8,50,30,22,23,5,29,43,67.4,14,38,8,30,55,105,52,1
Real Madrid,Kylian Mbappé,fr FRA,FW,25.0,32.4,8,5,1,3,4,1,5,20.0,4,3,0,3,1,9,1,1
Real Madrid,Aurélien Tchouaméni,fr FRA,DF,24.0,29.9,47,23,25,19,3,21,41,51.2,20,34,25,9,46,93,92,1
Real Madrid,Thibaut Courtois,be BEL,GK,32.0,30.0,0,0,0,0,0,0,0,,0,0,0,0,1,1,15,1
Real Madrid,Jude Bellingham,eng ENG,MF,21.0,27.7,61,33,20,27,14,28,42,66.7,14,37,2,35,28,89,23,1
Real Madrid,Antonio Rüdiger,de GER,DF,31.0,25.5,20,13,14,6,0,11,15,73.3,4,22,14,8,9,29,96,1
Real Madrid,Lucas Vázquez,es ESP,DF,33.0,24.4,58,34,33,17,8,27,48,56.3,21,24,6,18,17,75,35,1
Real Madrid,Vinicius Júnior,br BRA,FW,24.0,25.2,21,10,7,4,10,5,18,27.8,13,9,0,9,3,24,1,2
Real Madrid,Fran Garcia,es ESP,DF,24.0,24.2,51,36,29,16,6,28,51,54.9,23,27,5,22,28,79,67,1
Real Madrid,Rodrygo,br BRA,FW,23.0,21.6,21,14,14,5,2,7,23,30.4,16,18,1,17,11,32,9,0
Real Madrid,Raúl Asencio,es ESP,DF,21.0,18.6,22,16,18,4,0,10,13,76.9,3,11,6,5,16,38,88,2
Real Madrid,Luka Modrić,hr CRO,MF,38.0,20.4,31,20,16,13,2,14,32,43.8,18,17,5,12,27,58,17,0
Real Madrid,Brahim Díaz,ma MAR,FW,24.0,15.5,25,19,9,13,3,7,19,36.8,12,16,1,15,4,29,2,1
Real Madrid,Dani Ceballos,es ESP,MF,27.0,13.6,41,21,17,18,6,20,40,50.0,20,16,4,12,14,55,10,2
Real Madrid,Arda Güler,tr TUR,MF,19.0,14.0,30,16,11,8,11,9,22,40.9,13,18,0,18,7,37,8,0
Real Madrid,Ferland Mendy,fr FRA,DF,29.0,11.2,17,14,7,6,4,9,12,75.0,3,11,4,7,9,26,8,1
Real Madrid,Eduardo Camavinga,fr FRA,MF,21.0,12.3,42,26,23,16,3,19,33,57.6,14,24,8,16,18,60,23,0
Real Madrid,Éder Militão,br BRA,DF,26.0,10.4,19,17,14,5,0,7,12,58.3,5,13,8,5,12,31,35,0
Real Madrid,Andriy Lunin,ua UKR,GK,25.0,7.0,1,0,1,0,0,0,0,,0,0,0,0,0,1,3,0
Real Madrid,Dani Carvajal,es ESP,DF,32.0,6.8,12,8,7,3,2,9,12,75.0,3,8,3,5,10,22,19,1
Real Madrid,David Alaba,at AUT,DF,32.0,3.5,1,0,1,0,0,0,0,,0,5,5,0,6,7,7,0
Real Madrid,Endrick,br BRA,FW,18.0,4.1,1,1,1,0,0,1,3,33.3,2,0,0,0,4,5,1,0
Real Madrid,Jacobo Ramón,es ESP,DF,19.0,2.3,7,3,4,3,0,2,2,100.0,0,1,0,1,3,10,8,2
Real Madrid,Jesús Vallejo,es ESP,DF,27.0,1.5,0,0,0,0,0,0,0,,0,0,0,0,2,2,8,0
Real Madrid,Fran,es ESP,GK,19.0,1.0,0,0,0,0,0,0,0,,0,0,0,0,0,0,2,0
Real Madrid,Gonzalo García,es ESP,"FW,DF",20.0,0.6,0,0,0,0,0,0,0,,0,1,0,1,0,0,0,0
Real Madrid,Víctor Muñoz,es ESP,"FW,DF",21.0,0.4,0,0,0,0,0,0,0,,0,0,0,0,0,0,0,0
Real Madrid,Chema,es ESP,MF,19.0,0.1,0,0,0,0,0,0,0,,0,0,0,0,0,0,1,0
Real Madrid,Lorenzo Aguado,es ESP,DF,21.0,0.1,0,0,0,0,0,0,0,,0,0,0,0,0,0,2,0
Real Madrid,Daniel Yáñez,es ESP,FW,17.0,0.0,0,0,0,0,0,0,0,,0,0,0,0,0,0,0,0
Atletico Madrid,Jan Oblak,si SVN,GK,31.0,36.0,0,0,0,0,0,0,0,,0,0,0,0,0,0,17,2
Atletico Madrid,Julián Álvarez,ar ARG,FW,24.0,28.1,25,17,5,11,9,8,30,26.7,22,14,0,14,2,27,12,1
Atletico Madrid,Antoine Griezmann,fr FRA,FW,33.0,27.7,30,17,13,13,4,7,29,24.1,22,20,1,19,6,36,23,1
Atletico Madrid,Marcos Llorente,es ESP,DF,29.0,28.0,69,52,38,27,4,36,55,65.5,19,32,7,25,27,96,51,1
Atletico Madrid,Pablo Barrios,es ESP,MF,21.0,26.0,46,26,23,20,3,23,47,48.9,24,18,5,13,34,80,33,9
Atletico Madrid,Giuliano Simeone,ar ARG,MF,21.0,21.6,27,13,6,11,10,15,30,50.0,15,22,3,19,14,41,22,1
Atletico Madrid,Robin Le Normand,es ESP,DF,27.0,23.9,27,18,23,4,0,12,20,60.0,8,20,9,11,10,37,120,1
Atletico Madrid,Rodrigo De Paul,ar ARG,MF,30.0,23.6,33,26,12,16,5,14,33,42.4,19,25,2,23,6,39,15,3
Atletico Madrid,Clément Lenglet,fr FRA,DF,29.0,22.0,27,17,19,8,0,11,15,73.3,4,24,18,6,22,49,104,1
Atletico Madrid,Javi Galán,es ESP,DF,29.0,19.9,51,31,31,15,5,25,49,51.0,24,13,3,10,12,63,47,0
Atletico Madrid,Samuel Lino,br BRA,MF,24.0,17.4,33,17,25,4,4,22,52,42.3,30,23,4,19,8,41,13,0
Atletico Madrid,José María Giménez,uy URU,DF,29.0,22.2,26,16,18,8,0,17,28,60.7,11,29,19,10,27,53,115,2
Atletico Madrid,Koke,es ESP,MF,32.0,21.5,46,23,18,22,6,21,43,48.8,22,24,2,22,20,66,29,2
Atletico Madrid,Conor Gallagher,eng ENG,MF,24.0,18.3,45,32,16,19,10,22,49,44.9,27,23,5,18,20,65,23,0
Atletico Madrid,Nahuel Molina,ar ARG,DF,26.0,17.7,44,19,21,21,2,31,56,55.4,25,16,3,13,13,57,53,0
Atletico Madrid,Alexander Sørloth,no NOR,FW,28.0,17.5,9,5,2,5,2,3,6,50.0,3,6,1,5,1,10,28,0
Atletico Madrid,Reinildo Mandava,mz MOZ,DF,30.0,10.5,18,11,10,7,1,10,18,55.6,8,11,5,6,16,34,35,0
Atletico Madrid,César Azpilicueta,es ESP,DF,34.0,9.8,25,14,12,9,4,17,23,73.9,6,10,2,8,5,30,32,0
Atletico Madrid,Axel Witsel,be BEL,DF,35.0,9.5,16,12,4,10,2,12,14,85.7,2,15,8,7,11,27,34,1
Atletico Madrid,Rodrigo Riquelme,es ESP,MF,24.0,5.8,11,5,4,6,1,6,11,54.5,5,3,0,3,2,13,3,0
Atletico Madrid,Ángel Correa,ar ARG,FW,29.0,9.0,9,3,4,1,4,5,15,33.3,10,10,0,10,4,13,8,0
Atletico Madrid,Juan Musso,ar ARG,GK,30.0,2.0,0,0,0,0,0,0,0,,0,0,0,0,0,0,0,0
Atletico Madrid,Thomas Lemar,fr FRA,MF,28.0,0.9,2,1,1,1,0,2,4,50.0,2,0,0,0,0,2,1,0
Atletico Madrid,Adrian Niño,es ESP,FW,20.0,0.1,0,0,0,0,0,0,0,,0,0,0,0,0,0,0,0
Athletic Club,Iñaki Williams,gh GHA,FW,30.0,29.6,17,10,4,8,5,12,23,52.2,11,34,5,29,12,29,32,0
Athletic Club,Daniel Vivian,es ESP,DF,25.0,29.0,40,26,23,14,3,21,32,65.6,11,26,10,16,47,87,152,2
Athletic Club,Álex Berenguer,es ESP,FW,29.0,26.2,32,16,6,16,10,14,31,45.2,17,23,2,21,10,42,18,0
Athletic Club,Mikel Jauregizar,es ESP,MF,20.0,25.0,84,48,25,45,14,41,83,49.4,42,24,4,20,29,113,36,2
Athletic Club,Yuri Berchiche,es ESP,DF,34.0,22.7,33,21,19,11,3,19,33,57.6,14,25,5,20,27,60,72,3
Athletic Club,Nico Williams,es ESP,FW,22.0,22.3,28,18,10,11,7,11,32,34.4,21,20,1,19,7,35,9,0
Athletic Club,Unai Simón,es ESP,GK,27.0,21.0,0,0,0,0,0,0,0,,0,1,0,1,1,1,14,4
Athletic Club,Gorka Guruzeta,es ESP,FW,27.0,20.6,16,8,1,13,2,7,31,22.6,24,28,4,24,9,25,23,0
Athletic Club,Aitor Paredes,es ESP,DF,24.0,20.2,15,13,10,5,0,8,15,53.3,7,26,15,11,22,37,114,4
Athletic Club,Beñat Prados,es ESP,MF,23.0,19.2,55,36,20,27,8,25,53,47.2,28,21,2,19,28,83,26,0
Athletic Club,Yeray Álvarez,es ESP,DF,29.0,19.8,25,13,14,9,2,15,22,68.2,7,10,6,4,34,59,129,1
Athletic Club,Oihan Sancet,es ESP,MF,24.0,18.2,13,8,6,6,1,5,14,35.7,9,10,0,10,5,18,6,0
Athletic Club,Iñigo Ruiz de Galarreta,es ESP,MF,30.0,16.6,36,22,11,17,8,20,31,64.5,11,11,4,7,16,52,14,2
Athletic Club,Óscar de Marcos,es ESP,DF,35.0,17.4,32,15,15,13,4,21,37,56.8,16,17,1,16,16,48,35,0
Athletic Club,Andoni Gorosabel,es ESP,DF,27.0,16.6,47,28,31,9,7,30,45,66.7,15,18,2,16,18,65,62,0
Athletic Club,Unai Gómez,es ESP,MF,21.0,14.4,12,8,3,7,2,4,7,57.1,3,13,1,12,2,14,15,1
Athletic Club,Julen Agirrezabala,es ESP,GK,23.0,13.4,0,0,0,0,0,0,1,0.0,1,0,0,0,0,0,4,0
Athletic Club,Adama Boiro,es ESP,DF,22.0,12.3,20,11,11,7,2,10,15,66.7,5,10,3,7,12,32,27,1
Athletic Club,Mikel Vesga,es ESP,MF,31.0,11.0,22,15,7,13,2,12,28,42.9,16,10,1,9,15,37,26,0
Athletic Club,Iñigo Lekue,es ESP,DF,31.0,8.6,15,12,12,3,0,9,17,52.9,8,7,2,5,9,24,29,2
Athletic Club,Maroan Sannadi,ma MAR,FW,23.0,8.4,5,0,1,4,0,2,7,28.6,5,1,0,1,1,6,2,1
Athletic Club,Álvaro djaló,es ESP,FW,24.0,7.4,8,5,3,2,3,1,3,33.3,2,4,0,4,1,9,4,0
Athletic Club,Unai Núñez,es ESP,DF,27.0,7.2,10,5,7,3,0,4,7,57.1,3,4,4,0,17,27,46,1
Athletic Club,Alex Padilla,es ESP,GK,20.0,3.6,0,0,0,0,0,0,0,,0,0,0,0,0,0,2,1
Athletic Club,Ander Herrera,es ESP,MF,34.0,3.1,8,4,1,7,0,3,6,50.0,3,1,0,1,2,10,10,0
Athletic Club,Peio Canales,es ESP,MF,19.0,2.9,3,2,0,1,2,1,1,100.0,0,3,0,3,2,5,2,0
Athletic Club,Nicolás Serrano,es ESP,FW,21.0,1.3,1,1,0,1,0,1,3,33.3,2,4,0,4,1,2,1,0
Athletic Club,Aingeru Olabarrieta,es ESP,FW,18.0,0.6,0,0,0,0,0,0,0,,0,2,0,2,1,1,1,0
Athletic Club,Javi Martón,es ESP,FW,25.0,0.6,0,0,0,0,0,0,0,,0,0,0,0,0,0,0,0
Athletic Club,Adu Ares,es ESP,FW,22.0,0.2,0,0,0,0,0,0,1,0.0,1,0,0,0,0,0,0,0
Athletic Club,Endika Buján,es ESP,FW,21.0,0.1,0,0,0,0,0,0,1,0.0,1,0,0,0,0,0,0,0
Villarreal,Sergi Cardona,es ESP,DF,25.0,32.8,71,48,44,20,7,49,79,62.0,30,52,7,45,40,111,122,1
Villarreal,Alex Baena,es ESP,MF,23.0,29.0,28,15,6,14,8,10,39,25.6,29,29,2,27,22,50,22,2
Villarreal,Santi Comesaña,es ESP,MF,27.0,28.6,85,49,44,32,9,42,76,55.3,34,56,22,34,19,104,56,1
Villarreal,Logan Costa,cv CPV,DF,23.0,28.8,38,21,25,12,1,24,29,82.8,5,25,14,11,21,59,115,2
Villarreal,Kiko Femenía,es ESP,DF,33.0,24.8,50,34,34,14,2,33,57,57.9,24,21,10,11,40,90,62,3
Villarreal,Daniel Parejo,es ESP,MF,35.0,25.4,52,40,27,20,5,29,54,53.7,25,24,7,17,24,76,40,1
Villarreal,Pape Gueye,sn SEN,MF,25.0,24.8,54,26,23,23,8,20,29,69.0,9,31,13,18,27,81,53,2
Villarreal,Thierno Barry,fr FRA,FW,21.0,25.9,11,8,2,5,4,4,10,40.0,6,15,2,13,0,11,19,0
Villarreal,Yeremi Pino,es ESP,MF,21.0,21.8,60,32,20,32,8,32,65,49.2,33,38,3,35,8,68,18,0
Villarreal,Ayoze Pérez,es ESP,FW,31.0,22.0,27,14,5,18,4,6,24,25.0,18,17,0,17,8,35,15,0
Villarreal,Diego Conde,es ESP,GK,25.0,21.8,2,2,2,0,0,2,4,50.0,2,0,0,0,1,3,9,2
Villarreal,Juan Foyth,ar ARG,DF,26.0,16.9,25,15,15,6,4,11,16,68.8,5,26,17,9,19,44,119,3
Villarreal,Luiz Lúcio Reis Júnior,br BRA,GK,23.0,16.2,0,0,0,0,0,0,0,,0,0,0,0,0,0,14,1
Villarreal,Nicolas Pépé,ci CIV,FW,29.0,16.8,22,9,12,6,4,6,17,35.3,11,12,1,11,5,27,12,0
Villarreal,Raúl Albiol,es ESP,DF,38.0,13.2,10,9,9,1,0,6,10,60.0,4,10,9,1,6,16,69,1
Villarreal,Willy Kambwala,fr FRA,DF,19.0,12.4,17,12,14,2,1,10,12,83.3,2,10,7,3,10,27,56,1
Villarreal,Pau Navarro,es ESP,DF,19.0,10.2,23,17,15,6,2,19,39,48.7,20,13,6,7,4,27,41,0
Villarreal,Eric Bailly,ci CIV,DF,30.0,6.9,12,4,6,6,0,3,4,75.0,1,12,6,6,6,18,29,0
Villarreal,Denis Suárez,es ESP,MF,30.0,6.8,12,8,7,2,3,4,10,40.0,6,4,1,3,3,15,3,0
Villarreal,Ilias Akhomach,ma MAR,MF,20.0,6.6,12,7,4,4,4,6,12,50.0,6,8,0,8,3,15,13,0
Villarreal,Gerard Moreno,es ESP,FW,32.0,8.1,7,4,3,2,2,3,12,25.0,9,0,0,0,2,9,8,0
Villarreal,Alfonso Pedraza,es ESP,DF,28.0,5.1,3,2,2,0,1,2,4,50.0,2,3,1,2,6,9,16,0
Villarreal,Tajon Buchanan,ca CAN,MF,25.0,4.7,10,5,6,4,0,6,9,66.7,3,6,0,6,1,11,1,0
Villarreal,Arnaut Danjuma,nl NED,FW,27.0,2.3,2,1,0,1,1,0,1,0.0,1,1,0,1,0,2,0,0
Villarreal,Juan Bernat,es ESP,DF,31.0,2.4,9,7,7,1,1,4,5,80.0,1,3,1,2,1,10,4,0
Villarreal,Ramón Terrats,es ESP,MF,23.0,1.5,3,3,1,2,0,2,4,50.0,2,3,1,2,2,5,3,0
Villarreal,Pau Cabanes,es ESP,MF,19.0,1.8,4,4,0,3,1,3,4,75.0,1,5,0,5,3,7,2,1
Villarreal,Karl Etta,cm CMR,MF,20.0,0.4,0,0,0,0,0,0,1,0.0,1,1,0,1,0,0,0,0
Villarreal,Arnau Solà,es ESP,MF,21.0,0.1,0,0,0,0,0,0,2,0.0,2,1,1,0,0,0,0,0
Villarreal,Daniel Requena,es ESP,MF,20.0,0.1,0,0,0,0,0,0,0,,0,0,0,0,0,0,0,0
Villarreal,Thiago Ojeda,ar ARG,MF,21.0,0.1,0,0,0,0,0,0,0,,0,0,0,0,0,0,1,0
Real Betis,Diego Llorente,es ESP,DF,30.0,28.0,36,20,23,12,1,25,38,65.8,13,29,20,9,43,79,154,1
Real Betis,Johnny Cardoso,us USA,MF,22.0,23.9,55,31,12,35,8,20,52,38.5,32,27,12,15,48,103,64,1
Real Betis,Natan,br BRA,DF,23.0,24.2,35,24,24,9,2,26,30,86.7,4,24,14,10,28,63,123,2
Real Betis,Marc Bartra,es ESP,DF,33.0,23.4,33,19,20,13,0,15,26,57.7,11,41,25,16,33,66,148,0
Real Betis,Abde Ezzalzouli,ma MAR,FW,22.0,22.3,37,25,17,16,4,15,27,55.6,12,22,3,19,7,44,19,0
Real Betis,Romain Perraud,fr FRA,DF,26.0,22.3,36,22,15,16,5,21,46,45.7,25,18,4,14,22,58,71,1
Real Betis,Sergi Altimira,es ESP,MF,22.0,22.0,61,37,17,38,6,36,60,60.0,24,28,1,27,24,85,43,3
Real Betis,Pablo Fornals,es ESP,MF,28.0,20.5,21,13,12,6,3,10,30,33.3,20,24,4,20,23,44,15,1
Real Betis,Youssouf Sabaly,sn SEN,DF,31.0,17.7,40,25,21,15,4,24,32,75.0,8,21,4,17,13,53,40,0
Real Betis,Adrián,es ESP,GK,37.0,19.0,0,0,0,0,0,0,3,0.0,3,0,0,0,0,0,14,3
Real Betis,Isco,es ESP,MF,32.0,17.3,20,13,3,13,4,7,28,25.0,21,10,0,10,11,31,7,0
Real Betis,Giovani Lo Celso,ar ARG,MF,28.0,16.3,34,22,8,17,9,17,25,68.0,8,14,2,12,5,39,3,1
Real Betis,Antony,br BRA,FW,24.0,15.2,25,11,6,9,10,8,22,36.4,14,12,1,11,10,35,9,1
Real Betis,Rui Silva,pt POR,GK,30.0,15.0,0,0,0,0,0,0,1,0.0,1,1,0,1,0,0,7,0
Real Betis,Ricardo Rodríguez,ch SUI,DF,31.0,14.2,28,15,16,5,7,17,26,65.4,9,10,1,9,8,36,51,0
Real Betis,Jesus Rodríguez,es ESP,FW,18.0,12.5,16,14,6,6,4,5,18,27.8,13,16,0,16,6,22,3,0
Real Betis,Vitor Roque,br BRA,FW,19.0,13.8,11,6,1,6,4,1,5,20.0,4,5,0,5,7,18,4,0
Real Betis,Cucho,co COL,FW,25.0,12.8,15,10,2,5,8,6,11,54.5,5,13,1,12,7,22,4,0
Real Betis,Aitor Ruibal,es ESP,DF,28.0,14.7,32,23,22,4,6,25,47,53.2,22,20,5,15,14,46,40,1
Real Betis,Marc Roca,es ESP,MF,27.0,10.1,20,14,10,9,1,9,17,52.9,8,17,5,12,14,34,14,2
Real Betis,Cédric Bakambu,cd COD,FW,33.0,7.9,6,4,0,5,1,3,7,42.9,4,13,2,11,0,6,5,0
Real Betis,Ezequiel Ávila,ar ARG,FW,30.0,7.6,8,3,2,2,4,4,10,40.0,6,4,0,4,2,10,8,0
Real Betis,Héctor Bellerín,es ESP,DF,29.0,6.4,13,7,7,4,2,10,17,58.8,7,5,3,2,6,19,21,0
Real Betis,William Carvalho,pt POR,MF,32.0,5.4,9,6,3,6,0,4,6,66.7,2,6,2,4,3,12,6,0
Real Betis,Fran Vieites,es ESP,GK,25.0,4.0,0,0,0,0,0,0,0,,0,0,0,0,0,0,1,0
Real Betis,Ángel Ortíz,es ESP,DF,20.0,3.9,12,8,8,3,1,8,17,47.1,9,6,0,6,5,17,7,0
Real Betis,Iker Losada,es ESP,MF,22.0,3.8,10,7,2,4,4,5,10,50.0,5,2,0,2,3,13,2,0
Real Betis,Assane Diao,sn SEN,FW,18.0,3.1,5,3,1,3,1,4,9,44.4,5,3,0,3,0,5,3,0
Real Betis,Juanmi,es ESP,FW,31.0,2.7,7,4,3,3,1,4,6,66.7,2,4,0,4,1,8,4,0
Real Betis,Nabil Fekir,fr FRA,MF,31.0,2.0,3,2,1,1,1,1,2,50.0,1,2,0,2,0,3,0,0
Real Betis,Carlos Guirao,es ESP,MF,21.0,1.2,5,3,1,4,0,4,6,66.7,2,1,1,0,3,8,2,0
Real Betis,Mateo Flores,es ESP,MF,20.0,1.7,3,1,3,0,0,1,1,100.0,0,1,0,1,2,5,3,0
Real Betis,Rodri,es ESP,FW,24.0,1.3,2,1,1,1,0,1,2,50.0,1,2,1,1,1,3,1,1
Real Betis,Nobel Mendy,fr FRA,DF,19.0,1.2,0,0,0,0,0,0,0,,0,2,0,2,4,4,10,1
Real Betis,Sergio Arribas,es ESP,DF,21.0,1.0,7,4,4,3,0,6,7,85.7,1,2,2,0,3,10,4,0
Real Betis,Pablo Garcia,es ESP,FW,17.0,0.4,0,0,0,0,0,0,0,,0,1,0,1,0,0,0,0
Celta Vigo,Vicente Guaita,es ESP,GK,37.0,34.0,0,0,0,0,0,0,0,,0,0,0,0,0,0,21,3
Celta Vigo,Óscar Mingueza,es ESP,MF,25.0,30.4,38,24,21,12,5,26,69,37.7,43,35,5,30,22,60,46,7
Celta Vigo,Marcos Alonso,es ESP,DF,33.0,29.4,35,21,19,13,3,25,44,56.8,19,22,7,15,34,69,126,4
Celta Vigo,Fran Beltrán,es ESP,MF,25.0,27.0,50,35,24,21,5,24,56,42.9,32,26,6,20,26,76,34,4
Celta Vigo,Javi Rodríguez,es ESP,DF,21.0,28.0,53,38,35,17,1,33,47,70.2,14,29,10,19,33,86,96,2
Celta Vigo,Carl Starfelt,se SWE,DF,29.0,25.2,40,20,25,14,1,18,27,66.7,9,29,21,8,31,71,129,3
Celta Vigo,Borja Iglesias,es ESP,FW,31.0,21.9,10,9,2,5,3,4,15,26.7,11,9,2,7,7,17,10,0
Celta Vigo,Ilaix Moriba,gn GUI,MF,21.0,23.8,68,42,24,30,14,32,57,56.1,25,29,4,25,14,82,33,1
Celta Vigo,Iago Aspas,es ESP,FW,36.0,19.5,13,8,4,5,4,8,20,40.0,12,18,1,17,8,21,5,0
Celta Vigo,Sergio Carreira,es ESP,MF,23.0,18.4,28,16,16,6,6,14,26,53.8,12,20,2,18,17,45,37,0
Celta Vigo,Hugo Álvarez,es ESP,MF,21.0,17.5,26,9,12,10,4,10,19,52.6,9,19,2,17,8,34,29,1
Celta Vigo,Pablo Durán,es ESP,FW,23.0,15.6,17,9,4,7,6,5,16,31.3,11,12,3,9,8,25,18,0
Celta Vigo,Williot Swedberg,se SWE,FW,20.0,15.1,23,16,9,10,4,13,20,65.0,7,12,1,11,3,26,10,1
Celta Vigo,Hugo Sotelo,es ESP,MF,20.0,14.0,28,17,8,10,10,13,31,41.9,18,9,1,8,5,33,9,1
Celta Vigo,Alfon,es ESP,FW,25.0,15.3,8,3,3,2,3,4,12,33.3,8,8,0,8,5,13,5,1
Celta Vigo,Carlos Dominguez,es ESP,DF,23.0,13.1,23,11,14,9,0,15,21,71.4,6,16,11,5,13,36,80,1
Celta Vigo,Damián Rodríguez,es ESP,MF,21.0,10.3,14,9,3,10,1,6,16,37.5,10,6,1,5,7,21,13,0
Celta Vigo,Jonathan Bamba,ci CIV,FW,28.0,9.1,12,7,4,6,2,5,12,41.7,7,6,0,6,5,17,6,0
Celta Vigo,Fer López,,FW,nan,7.5,9,5,1,6,2,2,13,15.4,11,10,0,10,2,11,7,0
Celta Vigo,Yoel Lago,es ESP,DF,20.0,6.5,12,8,8,3,1,7,9,77.8,2,5,4,1,4,16,30,0
Celta Vigo,Javier Manquillo,es ESP,DF,30.0,5.8,7,5,4,3,0,2,10,20.0,8,5,3,2,7,14,14,0
Celta Vigo,Anastasios Douvikas,gr GRE,FW,24.0,7.8,9,4,2,6,1,3,6,50.0,3,5,2,3,3,12,6,0
Celta Vigo,Jailson Siqueira,br BRA,DF,28.0,6.9,13,11,9,3,1,9,11,81.8,2,6,4,2,9,22,28,1
Celta Vigo,Mihailo Ristić,rs SRB,DF,28.0,4.8,7,7,4,2,1,4,6,66.7,2,1,0,1,2,9,18,0
Celta Vigo,Iker Losada,es ESP,FW,22.0,4.0,3,3,0,1,2,1,5,20.0,4,4,1,3,1,4,8,0
Celta Vigo,Iván Villar,es ESP,GK,27.0,4.0,0,0,0,0,0,0,0,,0,0,0,0,0,0,3,0
Celta Vigo,Franco Cervi,ar ARG,FW,30.0,3.1,8,3,2,6,0,3,8,37.5,5,4,0,4,8,16,7,0
Celta Vigo,Luca de la Torre,us USA,MF,26.0,0.0,0,0,0,0,0,0,0,,0,0,0,0,0,0,0,0
Celta Vigo,Joseph Aidoo,gh GHA,DF,28.0,0.0,1,0,1,0,0,0,0,,0,0,0,0,0,1,0,0
Celta Vigo,Tadeo Allende,ar ARG,FW,25.0,0.0,0,0,0,0,0,0,0,,0,0,0,0,0,0,0,0
Rayo Vallecano,Florian Lejeune,fr FRA,DF,33.0,37.0,46,28,30,14,2,23,43,53.5,20,38,32,6,41,87,181,1
Rayo Vallecano,Andrei Ratiu,ro ROU,DF,26.0,34.1,71,41,40,21,10,42,70,60.0,28,45,5,40,27,98,73,2
Rayo Vallecano,Augusto Batalla,ar ARG,GK,28.0,32.0,4,2,4,0,0,4,6,66.7,2,0,0,0,0,4,15,4
Rayo Vallecano,Jorge de Frutos,es ESP,FW,27.0,28.0,37,21,16,13,8,14,46,30.4,32,22,0,22,19,56,24,1
Rayo Vallecano,Pep Chavarría,es ESP,DF,26.0,28.8,46,36,30,14,2,28,45,62.2,17,35,9,26,30,76,108,1
Rayo Vallecano,Álvaro García,es ESP,FW,31.0,28.6,33,24,19,8,6,12,31,38.7,19,31,0,31,32,65,42,1
Rayo Vallecano,Isaac Palazón Camacho,es ESP,MF,29.0,24.2,22,17,10,6,6,8,34,23.5,26,22,3,19,8,30,13,1
Rayo Vallecano,Pathé Ciss,sn SEN,MF,30.0,23.9,49,24,26,22,1,20,41,48.8,21,31,10,21,40,89,61,3
Rayo Vallecano,Abdul Mumin,gh GHA,DF,26.0,22.4,37,25,30,7,0,17,27,63.0,10,40,29,11,23,60,125,0
Rayo Vallecano,Unai López,es ESP,MF,28.0,19.2,31,21,14,12,5,17,36,47.2,19,18,6,12,21,52,20,0
Rayo Vallecano,Óscar Valentín,es ESP,MF,29.0,20.5,55,41,21,20,14,33,76,43.4,43,36,8,28,21,76,51,2
Rayo Vallecano,Adri Embarba,es ESP,FW,32.0,18.0,41,20,17,17,7,18,47,38.3,29,18,1,17,13,54,14,2
Rayo Vallecano,Randy Nteka,ao ANG,FW,26.0,12.7,16,5,3,9,4,5,12,41.7,7,13,2,11,4,20,20,0
Rayo Vallecano,Sergio Camello,es ESP,FW,23.0,12.8,9,3,2,5,2,4,6,66.7,2,8,1,7,4,13,16,0
Rayo Vallecano,Pedro Díaz,es ESP,MF,26.0,13.5,23,15,7,14,2,14,41,34.1,27,16,0,16,7,30,7,1
Rayo Vallecano,Iván Balliu,al ALB,DF,32.0,13.4,17,14,8,5,4,6,18,33.3,12,16,4,12,13,30,39,0
Rayo Vallecano,Aridane Hernández,es ESP,DF,35.0,11.4,13,11,9,4,0,6,8,75.0,2,10,8,2,6,19,99,2
Rayo Vallecano,Alfonso Espino,uy URU,DF,32.0,9.3,41,24,31,8,2,26,47,55.3,21,19,6,13,12,53,32,1
Rayo Vallecano,Gerard Gumbau,es ESP,MF,29.0,9.5,17,12,8,7,2,7,15,46.7,8,13,4,9,5,22,13,0
Rayo Vallecano,Dani Cárdenas,es ESP,GK,27.0,6.0,0,0,0,0,0,0,0,,0,0,0,0,0,0,3,0
Rayo Vallecano,Óscar Trejo,ar ARG,MF,36.0,5.6,8,5,1,5,2,3,9,33.3,6,9,0,9,4,12,5,0
Rayo Vallecano,Sergi Guardiola,es ESP,FW,33.0,4.0,5,3,0,5,0,2,3,66.7,1,1,0,1,1,6,2,0
Rayo Vallecano,James Rodríguez,co COL,MF,33.0,1.6,3,2,1,2,0,0,2,0.0,2,2,0,2,1,4,0,0
Rayo Vallecano,Pelayo Fernandez,es ESP,DF,21.0,1.1,0,0,0,0,0,0,0,,0,0,0,0,2,2,9,0
Rayo Vallecano,Etienne Eto'o,cm CMR,FW,21.0,0.4,0,0,0,0,0,0,1,0.0,1,0,0,0,0,0,1,0
Rayo Vallecano,Raúl de Tomás,es ESP,DF,29.0,0.2,2,2,1,0,1,0,0,,0,0,0,0,0,2,0,0
Osasuna,Sergio Herrera,es ESP,GK,31.0,37.0,2,1,2,0,0,2,6,33.3,4,1,0,1,0,2,29,1
Osasuna,Jesús Areso,es ESP,DF,25.0,34.3,53,38,31,14,8,39,56,69.6,17,26,4,22,8,61,92,0
Osasuna,Catena,es ESP,DF,29.0,34.2,46,28,34,10,2,27,44,61.4,17,40,25,15,35,81,221,2
Osasuna,Aimar Oroz,es ESP,MF,22.0,33.2,35,19,16,13,6,14,46,30.4,32,29,2,27,20,55,10,0
Osasuna,Lucas Torró,es ESP,MF,30.0,32.9,74,41,34,35,5,36,64,56.3,28,36,9,27,45,119,70,3
Osasuna,Ante Budimir,hr CRO,FW,33.0,33.0,20,9,3,11,6,3,13,23.1,10,19,4,15,2,22,26,0
Osasuna,Enzo Boyomo,cm CMR,DF,22.0,33.2,68,43,46,18,4,30,39,76.9,9,34,19,15,44,112,137,3
Osasuna,Rubén García,es ESP,FW,31.0,27.1,52,31,20,21,11,26,60,43.3,34,37,3,34,15,67,34,1
Osasuna,Jon Moncayola,es ESP,MF,26.0,23.5,70,41,29,33,8,31,60,51.7,29,34,3,31,11,81,20,0
Osasuna,Bryan Zaragoza,es ESP,FW,23.0,20.6,13,9,8,4,1,6,21,28.6,15,10,0,10,4,17,8,0
Osasuna,Abel,es ESP,DF,23.0,23.1,61,37,28,25,8,39,63,61.9,24,29,4,25,18,79,64,2
Osasuna,Juan Cruz Armada,es ESP,DF,32.0,16.7,26,14,11,13,2,15,24,62.5,9,15,4,11,9,35,68,0
Osasuna,Jorge Herrando,es ESP,DF,23.0,15.2,17,11,9,5,3,9,15,60.0,6,20,14,6,12,29,65,2
Osasuna,Pablo Ibáñez,es ESP,MF,25.0,14.5,20,10,7,12,1,10,40,25.0,30,20,7,13,18,38,21,0
Osasuna,Rubén Peña,es ESP,"FW,DF",33.0,8.7,12,5,4,3,5,5,24,20.8,19,11,0,11,6,18,12,0
Osasuna,Moi Gómez,es ESP,MF,30.0,8.9,13,9,4,7,2,4,8,50.0,4,5,2,3,6,19,7,1
Osasuna,Raúl,es ESP,FW,23.0,8.4,13,8,3,6,4,5,10,50.0,5,4,0,4,0,13,6,0
Osasuna,Iker Muñoz,es ESP,MF,21.0,6.8,5,2,3,2,0,3,9,33.3,6,9,2,7,4,9,12,1
Osasuna,Kike Barja,es ESP,FW,27.0,3.5,5,4,1,3,1,2,4,50.0,2,5,0,5,3,8,4,0
Osasuna,José Arnaiz,es ESP,FW,29.0,1.5,7,5,3,3,1,4,7,57.1,3,2,0,2,5,12,1,0
Osasuna,Nacho Vidal,es ESP,DF,29.0,1.4,2,0,0,1,1,1,4,25.0,3,1,0,1,0,2,6,0
Osasuna,Aitor Fernández,es ESP,GK,33.0,1.0,0,0,0,0,0,0,0,,0,0,0,0,0,0,2,0
Osasuna,Unai García,es ESP,DF,32.0,0.7,0,0,0,0,0,0,0,,0,1,0,1,0,0,1,0
Osasuna,Iker Benito,es ESP,FW,21.0,0.4,0,0,0,0,0,0,1,0.0,1,0,0,0,1,1,2,0
Osasuna,Javi Martínez,es ESP,MF,24.0,0.1,0,0,0,0,0,0,0,,0,0,0,0,0,0,0,0
Mallorca,Antonio Raillo,es ESP,DF,32.0,35.6,31,18,18,10,3,14,20,70.0,6,51,38,13,29,60,222,1
Mallorca,Sergi Darder,es ESP,MF,30.0,30.7,40,26,15,16,9,17,46,37.0,29,19,1,18,16,56,23,1
Mallorca,Dominik Greif,sk SVK,GK,27.0,31.0,0,0,0,0,0,0,0,,0,0,0,0,0,0,13,1
Mallorca,Martin Valjent,sk SVK,DF,28.0,30.7,30,21,22,7,1,15,25,60.0,10,32,21,11,18,48,195,1
Mallorca,Samu Costa,pt POR,MF,23.0,29.5,90,44,45,42,3,35,79,44.3,44,48,15,33,32,122,85,1
Mallorca,Johan Mojica,co COL,DF,31.0,30.7,35,23,26,6,3,19,40,47.5,21,13,5,8,26,61,84,3
Mallorca,Pablo Maffeo,es ESP,DF,27.0,26.4,60,40,43,14,3,34,46,73.9,12,32,11,21,25,85,103,1
Mallorca,Dani Rodríguez,es ESP,MF,36.0,24.3,49,29,18,21,10,14,27,51.9,13,22,3,19,12,61,30,0
Mallorca,Vedat Muriqi,xk KVX,FW,30.0,23.0,7,5,3,2,2,3,7,42.9,4,7,1,6,7,14,43,0
Mallorca,Omar Mascarell,gq EQG,MF,31.0,22.2,27,13,13,13,1,14,35,40.0,21,33,21,12,49,76,59,3
Mallorca,Cyle Larin,ca CAN,FW,29.0,19.8,12,6,1,6,5,3,9,33.3,6,12,3,9,1,13,16,0
Mallorca,Copete,es ESP,DF,24.0,17.0,29,17,18,10,1,11,12,91.7,1,24,16,8,17,46,123,2
Mallorca,Manu Morlanes,es ESP,MF,25.0,15.0,43,27,18,20,5,18,30,60.0,12,19,8,11,24,67,16,0
Mallorca,Roberto Navarro,es ESP,MF,22.0,14.4,29,22,14,11,4,9,19,47.4,10,18,0,18,19,48,12,0
Mallorca,Takuma Asano,jp JPN,FW,29.0,11.9,13,9,5,7,1,6,11,54.5,5,7,0,7,6,19,9,0
Mallorca,Antonio Sánchez,es ESP,MF,27.0,15.6,28,16,16,8,4,14,36,38.9,22,16,2,14,18,46,36,1
Mallorca,Mateu Morey,es ESP,DF,24.0,8.3,22,18,13,6,3,12,22,54.5,10,11,0,11,15,37,32,2
Mallorca,Leo Román,es ESP,GK,24.0,7.0,0,0,0,0,0,0,0,,0,0,0,0,0,0,6,0
Mallorca,Toni Lato,es ESP,DF,26.0,6.9,17,11,6,5,6,7,11,63.6,4,10,4,6,6,23,33,0
Mallorca,Abdón Prats,es ESP,FW,31.0,5.1,2,1,1,1,0,1,2,50.0,1,2,1,1,1,3,5,0
Mallorca,Marc Domenech,es ESP,FW,18.0,3.4,4,4,2,1,1,2,5,40.0,3,2,0,2,0,4,2,0
Mallorca,David López,es ESP,DF,21.0,1.9,3,2,3,0,0,2,2,100.0,0,2,2,0,1,4,10,0
Mallorca,Valery Fernández,es ESP,MF,24.0,3.4,8,7,3,2,3,5,7,71.4,2,3,1,2,0,8,1,0
Mallorca,Chiquinho,pt POR,MF,24.0,1.6,1,0,0,1,0,0,7,0.0,7,3,0,3,2,3,0,0
Mallorca,Siebe Van Der Heyden,be BEL,DF,26.0,1.1,1,1,0,1,0,0,0,,0,1,0,1,2,3,3,0
Mallorca,Javier Llabrés,es ESP,FW,21.0,0.6,0,0,0,0,0,0,0,,0,1,0,1,0,0,0,0
Mallorca,Jan Salas,es ESP,MF,18.0,0.5,3,1,2,1,0,2,2,100.0,0,0,0,0,0,3,0,0
Mallorca,Daniel Luna,co COL,MF,21.0,0.2,0,0,0,0,0,0,0,,0,1,0,1,0,0,0,0
Real Sociedad,Álex Remiro,es ESP,GK,29.0,36.0,1,0,1,0,0,1,2,50.0,1,0,0,0,0,1,18,4
Real Sociedad,Martín Zubimendi,es ESP,MF,25.0,32.9,73,37,31,29,13,28,44,63.6,16,42,16,26,44,117,79,3
Real Sociedad,Sergio Gómez,es ESP,MF,23.0,30.6,71,39,30,29,12,30,56,53.6,26,44,3,41,19,90,30,2
Real Sociedad,Jon Aramburu,ve VEN,DF,22.0,27.4,102,70,61,30,11,66,100,66.0,34,40,8,32,30,132,98,0
Real Sociedad,Mikel Oyarzabal,es ESP,FW,27.0,25.2,25,16,9,10,6,10,23,43.5,13,17,1,16,4,29,15,0
Real Sociedad,Takefusa Kubo,jp JPN,MF,23.0,26.5,31,20,11,11,9,16,40,40.0,24,38,1,37,17,48,13,1
Real Sociedad,Igor Zubeldia,es ESP,DF,27.0,25.2,34,22,21,10,3,14,26,53.8,12,32,18,14,31,65,100,2
Real Sociedad,Javi López,es ESP,DF,22.0,21.6,40,23,23,12,5,23,37,62.2,14,21,7,14,11,51,59,2
Real Sociedad,Luka Sučić,hr CRO,MF,21.0,20.0,25,18,8,12,5,10,26,38.5,16,30,2,28,15,40,16,1
Real Sociedad,Nayef Aguerd,ma MAR,DF,28.0,19.6,30,24,17,12,1,12,18,66.7,6,21,15,6,13,43,91,0
Real Sociedad,Brais Méndez,es ESP,MF,27.0,17.2,24,13,6,14,4,9,24,37.5,15,14,1,13,7,31,16,1
Real Sociedad,Aritz Elustondo,es ESP,DF,30.0,16.2,20,11,15,3,2,11,19,57.9,8,17,12,5,11,31,96,0
Real Sociedad,Ander Barrenetxea,es ESP,MF,22.0,14.2,26,19,7,14,5,6,23,26.1,17,15,0,15,11,37,16,1
Real Sociedad,Pablo Marín,es ESP,MF,21.0,13.8,25,17,6,13,6,10,19,52.6,9,12,3,9,5,30,14,0
Real Sociedad,Aihen Muñoz,es ESP,DF,26.0,12.3,24,12,14,8,2,14,28,50.0,14,11,6,5,14,38,47,0
Real Sociedad,Sheraldo Becker,sr SUR,FW,29.0,11.1,3,2,0,3,0,0,2,0.0,2,4,0,4,1,4,10,0
Real Sociedad,Beñat Turrientes,es ESP,MF,22.0,10.5,15,6,4,10,1,4,15,26.7,11,15,3,12,5,20,14,1
Real Sociedad,Orri Steinn Óskarsson,is ISL,FW,19.0,10.6,6,6,2,1,3,2,8,25.0,6,10,1,9,2,8,11,0
Real Sociedad,Jon Pacheco,es ESP,DF,23.0,9.5,15,9,12,3,0,10,12,83.3,2,8,6,2,9,24,49,2
Real Sociedad,Hamari Traoré,ml MLI,DF,32.0,7.9,19,12,10,7,2,15,22,68.2,7,6,2,4,9,28,21,0
Real Sociedad,Olasagasti,es ESP,MF,23.0,9.6,21,10,7,9,5,8,18,44.4,10,8,2,6,15,36,10,0
Real Sociedad,Jon Martin,es ESP,DF,18.0,10.0,11,9,7,3,1,6,9,66.7,3,13,9,4,7,18,80,1
Real Sociedad,Umar Sadiq,ng NGA,FW,27.0,2.5,2,1,1,1,0,1,2,50.0,1,3,1,2,1,3,2,0
Real Sociedad,Unai Marrero,es ESP,GK,22.0,2.0,0,0,0,0,0,0,0,,0,0,0,0,0,0,1,0
Real Sociedad,Arkaitz Mariezkurrena,es ESP,FW,19.0,2.7,1,0,1,0,0,0,4,0.0,4,4,1,3,1,2,4,0
Real Sociedad,Arsen Zakharyan,ru RUS,MF,21.0,0.8,1,1,1,0,0,1,1,100.0,0,1,1,0,1,2,0,0
Real Sociedad,Urko González,es ESP,MF,23.0,0.5,0,0,0,0,0,0,0,,0,1,1,0,0,0,0,0
Real Sociedad,Álvaro Odriozola,es ESP,DF,28.0,0.5,1,1,1,0,0,0,0,,0,0,0,0,0,1,1,0
Real Sociedad,Daniel Díaz,es ESP,MF,18.0,0.1,1,1,1,0,0,0,0,,0,1,0,1,0,1,0,0
Real Sociedad,Luken Beitia,es ESP,DF,20.0,0.1,1,1,1,0,0,1,1,100.0,0,0,0,0,0,1,2,0
Real Sociedad,Jon Magunazelaia,es ESP,MF,23.0,0.1,1,1,1,0,0,0,0,,0,0,0,0,0,1,0,0
Valencia,Cristhian Mosquera,es ESP,DF,20.0,36.9,56,36,41,13,2,31,40,77.5,9,37,24,13,35,91,128,4
Valencia,Diego López,es ESP,MF,22.0,30.7,31,18,11,16,4,16,47,34.0,31,30,0,30,16,47,15,0
Valencia,Giorgi Mamardashvili,ge GEO,GK,23.0,34.0,2,2,2,0,0,2,3,66.7,1,0,0,0,1,3,16,3
Valencia,César Tárrega,es ESP,DF,22.0,33.6,49,37,33,13,3,19,31,61.3,12,41,20,21,22,71,222,2
Valencia,Luis Rioja,es ESP,MF,30.0,31.7,33,21,14,12,7,14,42,33.3,28,30,1,29,22,55,44,1
Valencia,Javier Guerra,es ESP,MF,21.0,28.9,50,27,18,21,11,26,56,46.4,30,15,3,12,20,70,49,3
Valencia,Enzo Barrenechea,ar ARG,MF,23.0,24.6,57,30,22,29,6,32,46,69.6,14,30,8,22,28,85,48,1
Valencia,Dimitri Foulquier,fr FRA,DF,31.0,25.6,48,31,29,13,6,24,36,66.7,12,21,5,16,16,64,86,1
Valencia,Hugo Duro,es ESP,FW,24.0,24.2,13,8,4,7,2,5,13,38.5,8,11,2,9,10,23,11,0
Valencia,Domingos André Ribeiro Almeida,pt POR,MF,24.0,22.2,48,32,18,21,9,14,39,35.9,25,21,3,18,8,56,14,1
Valencia,José Luis Gayà,es ESP,DF,29.0,20.1,57,40,39,15,3,40,58,69.0,18,16,2,14,25,82,61,0
Valencia,José Luis García Vayá,es ESP,MF,25.0,19.4,43,25,24,13,6,19,33,57.6,14,23,6,17,19,62,42,0
Valencia,Jesus Vazquez,es ESP,DF,21.0,10.3,23,18,12,9,2,10,19,52.6,9,16,5,11,10,33,30,0
Valencia,Yarek Gasiorowski,es ESP,DF,19.0,10.6,19,16,16,3,0,9,13,69.2,4,17,6,11,26,45,60,0
Valencia,Umar Sadiq,ng NGA,FW,27.0,9.2,10,5,3,5,2,4,6,66.7,2,7,0,7,1,11,7,0
Valencia,Thierry Correia,pt POR,DF,25.0,8.6,27,18,19,5,3,13,23,56.5,10,10,1,9,4,31,18,0
Valencia,Mouctar Diakhaby,gn GUI,DF,27.0,7.3,8,3,8,0,0,4,6,66.7,2,8,6,2,11,19,56,0
Valencia,Rafa Mir,es ESP,FW,27.0,8.4,12,6,8,4,0,3,9,33.3,6,5,0,5,5,17,9,0
Valencia,Dani Gómez,es ESP,FW,26.0,6.0,3,2,0,0,3,0,0,,0,1,0,1,2,5,4,0
Valencia,Francisco Perez,es ESP,FW,21.0,6.4,17,12,7,8,2,10,16,62.5,6,8,1,7,3,20,6,0
Valencia,Hugo Guillamón,es ESP,MF,24.0,4.1,11,8,1,9,1,9,10,90.0,1,4,1,3,5,16,9,1
Valencia,Stole Dimitrievski,mk MKD,GK,30.0,4.0,0,0,0,0,0,0,0,,0,0,0,0,0,0,3,1
Valencia,Sergi Canós,es ESP,MF,27.0,4.1,11,7,3,4,4,4,10,40.0,6,6,1,5,5,16,5,0
Valencia,Ivan Jaime Pajuelo,es ESP,MF,23.0,3.3,8,5,2,3,3,4,5,80.0,1,2,0,2,2,10,0,0
Valencia,Germán Valera,es ESP,MF,22.0,1.7,1,1,1,0,0,0,1,0.0,1,2,0,2,4,5,2,1
Valencia,Max Aarons,eng ENG,DF,24.0,1.3,4,4,2,2,0,4,5,80.0,1,1,0,1,0,4,3,0
Valencia,Maximiliano Caufriez,be BEL,DF,27.0,1.0,1,1,1,0,0,1,1,100.0,0,2,1,1,1,2,4,0
Valencia,Rodrigo Abajas,es ESP,DF,21.0,0.7,3,2,2,1,0,3,3,100.0,0,1,0,1,1,4,0,0
Valencia,Martín Tejón,es ESP,MF,20.0,0.5,2,0,0,2,0,1,2,50.0,1,0,0,0,0,2,0,0
Valencia,Iker Córdoba,es ESP,DF,18.0,0.2,0,0,0,0,0,0,0,,0,0,0,0,0,0,1,0
Valencia,David Otorbi,es ESP,MF,16.0,0.2,0,0,0,0,0,0,0,,0,1,0,1,0,0,0,0
Valencia,Alberto Marí,es ESP,FW,23.0,0.1,0,0,0,0,0,0,0,,0,0,0,0,0,0,0,0
Getafe,David Soria,es ESP,GK,31.0,38.0,4,4,4,0,0,4,5,80.0,1,0,0,0,1,5,21,3
Getafe,Omar Alderete,py PAR,DF,27.0,33.1,43,29,30,11,2,20,30,66.7,10,38,22,16,40,83,241,1
Getafe,Iglesias,es ESP,DF,26.0,32.1,81,47,42,33,6,46,90,51.1,44,47,8,39,50,131,133,1
Getafe,Luis Milla,es ESP,MF,29.0,32.0,61,40,28,25,8,35,72,48.6,37,25,0,25,24,85,28,3
Getafe,Diego Rico,es ESP,DF,31.0,31.3,81,49,47,29,5,47,85,55.3,38,41,3,38,34,115,102,2
Getafe,Mauro Arambarri,uy URU,MF,28.0,29.6,48,29,10,33,5,22,48,45.8,26,35,6,29,15,63,46,0
Getafe,Djené,tg TOG,DF,32.0,28.4,25,13,12,11,2,12,32,37.5,20,18,8,10,21,46,107,3
Getafe,Christantus Uche,ng NGA,FW,21.0,27.8,35,21,8,19,8,9,20,45.0,11,20,2,18,10,45,19,0
Getafe,Domingos Duarte,pt POR,DF,29.0,20.7,28,15,22,4,2,17,21,81.0,4,28,16,12,18,46,152,1
Getafe,Carles Pérez,es ESP,MF,26.0,16.0,33,23,11,14,8,21,48,43.8,27,19,2,17,6,39,22,0
Getafe,Ramón Terrats,es ESP,MF,23.0,13.7,20,10,7,8,5,8,28,28.6,20,9,2,7,8,28,16,0
Getafe,Bertuğ Yıldırım,tr TUR,FW,22.0,12.1,10,5,0,7,3,2,7,28.6,5,13,2,11,1,11,16,0
Getafe,Alex Sola,es ESP,MF,25.0,11.6,21,14,9,12,0,9,25,36.0,16,8,0,8,7,28,11,1
Getafe,Coba da Costa,es ESP,MF,22.0,11.3,29,13,9,16,4,13,26,50.0,13,24,0,24,8,37,10,0
Getafe,Juan Berrocal,es ESP,DF,25.0,11.9,14,7,10,4,0,10,14,71.4,4,6,3,3,15,29,59,0
Getafe,Allan Nyom,cm CMR,DF,36.0,9.9,18,11,7,9,2,15,17,88.2,2,4,2,2,4,22,23,0
Getafe,Juan Bernat,es ESP,MF,31.0,7.9,19,13,9,5,5,7,12,58.3,5,9,3,6,2,21,12,0
Getafe,Juanmi,es ESP,FW,31.0,7.8,14,11,4,7,3,6,19,31.6,13,6,0,6,2,16,3,0
Getafe,Borja Mayoral,es ESP,FW,27.0,12.4,5,4,2,2,1,3,9,33.3,6,4,0,4,2,7,6,0
Getafe,Álvaro Rodríguez,uy URU,FW,20.0,9.5,10,7,0,7,3,5,10,50.0,5,23,0,23,3,13,12,0
Getafe,Carles Aleñá,es ESP,MF,26.0,5.1,6,3,2,3,1,4,13,30.8,9,9,1,8,0,6,7,0
Getafe,Jesús Santiago,es ESP,MF,20.0,4.2,14,8,6,8,0,5,10,50.0,5,6,2,4,1,15,3,0
Getafe,Nabil Aberdin,fr FRA,MF,21.0,3.0,6,4,3,3,0,1,1,100.0,0,3,0,3,0,6,5,0
Getafe,Peter González,do DOM,MF,22.0,5.3,11,6,2,5,4,6,9,66.7,3,8,0,8,2,13,5,0
Getafe,Abdoulaye Keita,es ESP,FW,21.0,1.1,2,2,0,1,1,2,4,50.0,2,1,0,1,0,2,3,0
Getafe,Ismael Bekhoucha,ma MAR,MF,19.0,0.8,1,1,1,0,0,1,2,50.0,1,2,1,1,2,3,2,0
Getafe,Alberto Risco,es ESP,MF,18.0,0.8,4,4,2,0,2,1,6,16.7,5,2,0,2,0,4,0,0
Getafe,John Joe,ie IRL,MF,20.0,0.5,0,0,0,0,0,0,0,,0,1,1,0,0,0,1,0
Getafe,Gorka Rivera Alonso,es ESP,DF,19.0,0.2,2,0,0,2,0,2,2,100.0,0,0,0,0,0,2,0,0
Getafe,David Argüelles,es ESP,MF,22.0,0.1,0,0,0,0,0,0,0,,0,2,0,2,0,0,0,0
Espanyol,Joan García,es ESP,GK,23.0,38.0,0,0,0,0,0,0,1,0.0,1,1,0,1,0,0,18,4
Espanyol,Omar El Hilali,ma MAR,DF,20.0,35.1,111,79,81,24,6,64,95,67.4,31,53,13,40,46,157,145,2
Espanyol,Javi Puado,es ESP,FW,26.0,33.2,22,17,14,4,4,8,20,40.0,12,18,3,15,5,27,19,0
Espanyol,Marash Kumbulla,al ALB,DF,24.0,33.1,51,26,35,14,2,24,41,58.5,17,48,35,13,34,85,224,2
Espanyol,Leandro Cabrera,uy URU,DF,33.0,31.9,40,23,29,8,3,19,33,57.6,14,35,25,10,30,70,199,2
Espanyol,Alex Král,cz CZE,MF,26.0,30.2,55,37,28,24,3,16,30,53.3,14,34,14,20,28,83,51,2
Espanyol,Carlos Romero,es ESP,DF,22.0,28.5,73,47,49,16,8,45,82,54.9,37,50,15,35,30,103,102,1
Espanyol,Pol Lozano,es ESP,MF,24.0,21.8,53,34,23,25,5,25,58,43.1,33,32,6,26,22,75,31,0
Espanyol,Jofre,es ESP,MF,23.0,24.3,22,16,14,5,3,13,23,56.5,10,13,0,13,15,37,29,0
Espanyol,Roberto Férnandez,es ESP,FW,22.0,16.8,4,4,2,1,1,0,5,0.0,5,9,1,8,3,7,26,0
Espanyol,Urko González,es ESP,MF,23.0,15.4,46,28,24,21,1,28,44,63.6,16,27,12,15,8,54,39,1
Espanyol,Álvaro Tejero,es ESP,MF,28.0,13.9,14,4,7,6,1,7,23,30.4,16,9,1,8,13,27,34,1
Espanyol,Antoniu,es ESP,FW,21.0,11.5,21,10,9,8,4,9,21,42.9,12,14,2,12,8,29,11,1
Espanyol,Edu Expósito,es ESP,MF,27.0,11.7,23,13,9,13,1,9,23,39.1,14,3,0,3,15,38,21,2
Espanyol,Brian Oliván,es ESP,DF,30.0,11.3,13,10,7,6,0,4,13,30.8,9,6,2,4,10,23,23,0
Espanyol,Alejo Véliz,ar ARG,FW,20.0,12.6,1,1,0,1,0,1,7,14.3,6,12,2,10,4,5,23,1
Espanyol,José Gragera,es ESP,MF,23.0,6.4,25,16,11,14,0,9,17,52.9,8,9,1,8,5,30,13,0
Espanyol,Fernando Calero,es ESP,DF,28.0,8.0,18,10,13,4,1,8,12,66.7,4,16,9,7,16,34,50,1
Espanyol,Sergi Gómez,es ESP,DF,32.0,7.4,8,5,7,1,0,2,3,66.7,1,12,8,4,7,15,38,0
Espanyol,Walid Cheddira,ma MAR,FW,26.0,7.2,5,0,1,1,3,0,1,0.0,1,4,0,4,1,6,6,0
Espanyol,Irvin Cardona,fr FRA,FW,26.0,6.8,8,5,2,4,2,6,16,37.5,10,5,1,4,4,12,10,0
Espanyol,Álvaro Aguado,es ESP,MF,28.0,5.0,5,2,3,2,0,3,9,33.3,6,7,1,6,4,9,5,1
Espanyol,Justin Smith,ca CAN,MF,21.0,2.3,9,3,3,6,0,4,6,66.7,2,5,1,4,4,13,3,0
Espanyol,Rafael Bauza,es ESP,MF,19.0,2.1,5,3,3,1,1,4,7,57.1,3,3,1,2,0,5,5,0
Espanyol,Pere Milla,es ESP,MF,31.0,5.1,6,2,5,0,1,1,18,5.6,17,10,2,8,3,9,5,0
Espanyol,Naci Ünüvar,nl NED,MF,21.0,0.3,2,2,1,1,0,1,2,50.0,1,0,0,0,0,2,0,0
Espanyol,Roger Hinojo,es ESP,DF,19.0,0.1,0,0,0,0,0,0,0,,0,0,0,0,0,0,1,0
Alaves,Carlos Vicente,es ESP,FW,25.0,34.4,47,31,26,11,10,25,64,39.1,39,34,2,32,14,61,40,0
Alaves,Nahuel Tenaglia,ar ARG,DF,28.0,32.5,96,61,61,30,5,53,88,60.2,35,33,9,24,47,143,123,2
Alaves,Antonio Sivera,es ESP,GK,27.0,31.2,2,1,2,0,0,2,2,100.0,0,1,0,1,0,2,20,0
Alaves,Antonio Blanco,es ESP,MF,24.0,30.4,67,40,23,37,7,32,83,38.6,51,30,7,23,42,109,48,1
Alaves,Manu Sánchez,es ESP,DF,23.0,29.4,83,56,40,33,10,41,69,59.4,28,51,12,39,30,113,76,1
Alaves,Kiké,es ESP,FW,34.0,28.4,19,14,1,12,6,6,17,35.3,11,11,4,7,1,20,23,0
Alaves,Abdel Abqar,ma MAR,DF,25.0,27.4,36,23,24,11,1,20,34,58.8,14,28,18,10,39,75,146,1
Alaves,Jon Guridi,es ESP,MF,29.0,23.3,40,22,7,26,7,18,44,40.9,26,19,1,18,14,54,16,0
Alaves,Ander Guevara,es ESP,MF,27.0,21.7,49,30,19,29,1,20,48,41.7,28,21,5,16,14,63,43,1
Alaves,Moussa Diarra,ml MLI,DF,23.0,20.8,40,24,19,18,3,17,29,58.6,12,15,5,10,21,61,46,1
Alaves,Santiago Mouriño,uy URU,DF,22.0,20.6,43,28,31,12,0,21,38,55.3,17,27,12,15,29,72,120,0
Alaves,Carlos Martín,es ESP,FW,22.0,15.0,43,21,18,16,9,13,49,26.5,36,30,1,29,5,48,20,0
Alaves,Joan Jordán,es ESP,MF,30.0,15.8,32,18,11,17,4,17,30,56.7,13,12,0,12,9,41,21,0
Alaves,Carles Aleñá,es ESP,MF,26.0,12.2,19,12,6,7,6,7,17,41.2,10,11,0,11,2,21,4,0
Alaves,Toni Martínez,es ESP,FW,27.0,11.3,12,7,5,4,3,4,8,50.0,4,8,2,6,1,13,15,0
Alaves,Tomás Conechny,ar ARG,FW,26.0,9.5,15,12,6,7,2,9,27,33.3,18,14,2,12,6,21,10,0
Alaves,Facundo Garcés,my MAS,DF,24.0,7.5,6,2,4,2,0,3,5,60.0,2,8,6,2,5,11,51,0
Alaves,Aleksandar Sedlar,rs SRB,DF,32.0,6.6,18,10,7,11,0,8,10,80.0,2,2,1,1,10,28,24,1
Alaves,Stoichkov,es ESP,MF,30.0,7.8,14,9,6,7,1,6,11,54.5,5,2,0,2,1,15,7,0
Alaves,Carlos Benavídez,uy URU,MF,26.0,5.5,19,14,10,6,3,6,11,54.5,5,5,2,3,8,27,14,1
Alaves,Pica,es ESP,DF,22.0,5.6,9,7,7,2,0,4,9,44.4,5,7,6,1,9,18,26,0
Alaves,Jesús Owono,gq EQG,GK,23.0,5.4,1,1,1,0,0,1,1,100.0,0,0,0,0,0,1,2,0
Alaves,Abderrahman Rebbach,dz ALG,FW,25.0,4.3,3,2,3,0,0,0,6,0.0,6,4,0,4,0,3,6,0
Alaves,Asier Villalibre,es ESP,FW,26.0,3.7,2,2,0,1,1,1,2,50.0,1,1,0,1,1,3,7,0
Alaves,Hugo Novoa,es ESP,DF,21.0,2.6,8,5,4,3,1,5,5,100.0,0,2,1,1,0,8,6,0
Alaves,Luka Romero,ar ARG,FW,19.0,2.2,4,4,1,1,2,2,3,66.7,1,2,0,2,1,5,0,0
Alaves,Pau Cabanes,es ESP,MF,19.0,2.1,8,2,4,3,1,6,13,46.2,7,2,0,2,0,8,1,0
Alaves,Adrian Rodriguez,es ESP,GK,23.0,1.4,0,0,0,0,0,0,1,0.0,1,0,0,0,0,0,3,1
Alaves,Luis Rioja,es ESP,FW,30.0,0.3,2,1,0,1,1,1,2,50.0,1,2,0,2,0,2,0,0
Girona,Paulo Gazzaniga,ar ARG,GK,32.0,35.5,1,1,1,0,0,1,1,100.0,0,1,0,1,0,1,17,3
Girona,Daley Blind,nl NED,DF,34.0,30.9,49,27,26,19,4,31,48,64.6,17,32,9,23,32,81,94,2
Girona,Arnau Martinez,es ESP,DF,21.0,29.2,51,28,30,15,6,32,63,50.8,31,18,6,12,31,82,76,2
Girona,Miguel Gutiérrez,es ESP,DF,23.0,27.4,37,24,18,16,3,17,37,45.9,20,17,7,10,16,53,34,3
Girona,Ladislav Krejčí,cz CZE,DF,25.0,27.1,23,16,19,4,0,14,26,53.8,12,24,19,5,34,57,93,5
Girona,David López,es ESP,DF,34.0,27.0,32,24,22,7,3,18,31,58.1,13,22,12,10,14,46,111,2
Girona,Yangel Herrera,ve VEN,MF,26.0,25.2,66,39,31,27,8,30,59,50.8,29,24,8,16,31,97,50,2
Girona,Iván Martín,es ESP,MF,25.0,22.8,32,19,14,14,4,15,34,44.1,19,20,6,14,11,43,15,1
Girona,Viktor Tsyhankov,ua UKR,FW,26.0,21.4,19,12,4,7,8,9,19,47.4,10,7,1,6,15,34,16,1
Girona,Bryan Gil,es ESP,FW,23.0,19.3,34,20,10,15,9,14,30,46.7,16,24,0,24,10,44,9,4
Girona,Oriol Romeu,es ESP,MF,32.0,15.2,38,25,14,19,5,14,26,53.8,12,22,8,14,12,50,20,4
Girona,Abel Ruiz,es ESP,FW,24.0,15.1,6,2,2,2,2,2,5,40.0,3,7,2,5,5,11,7,0
Girona,Donny van de Beek,nl NED,MF,27.0,15.9,29,18,17,7,5,13,26,50.0,13,19,3,16,10,39,12,0
Girona,Yaser Asprilla,co COL,FW,20.0,15.7,22,12,6,8,8,8,23,34.8,15,14,0,14,7,29,7,1
Girona,Arnaut Danjuma,nl NED,FW,27.0,14.9,8,6,3,3,2,2,7,28.6,5,5,1,4,2,10,4,0
Girona,Alejandro Francés,es ESP,DF,21.0,13.1,36,24,22,13,1,28,40,70.0,12,17,8,9,17,53,52,0
Girona,Bojan Miovski,mk MKD,FW,25.0,9.8,7,5,2,2,3,2,7,28.6,5,4,0,4,2,9,7,0
Girona,Arthur Melo,br BRA,MF,27.0,10.5,25,11,8,12,5,14,27,51.9,13,5,1,4,8,33,12,1
Girona,Juanpe,es ESP,DF,33.0,8.1,8,5,5,3,0,6,8,75.0,2,15,10,5,8,16,56,1
Girona,Cristhian Stuani,uy URU,FW,37.0,12.0,9,7,1,7,1,5,8,62.5,3,4,1,3,7,16,11,0
Girona,Portu,es ESP,FW,32.0,8.7,13,7,5,5,3,7,10,70.0,3,8,0,8,0,13,2,0
Girona,Jhon Solis,co COL,MF,19.0,6.0,13,7,3,9,1,6,14,42.9,8,13,1,12,4,17,6,1
Girona,Krapyvtsov Vladyslav,ua UKR,GK,19.0,2.0,0,0,0,0,0,0,0,,0,0,0,0,0,0,1,1
Girona,Silvi Clúa,es ESP,MF,19.0,1.8,8,7,4,3,1,4,6,66.7,2,1,0,1,2,10,6,0
Girona,Gabriel Osei Misehouy,nl NED,FW,19.0,2.9,1,1,0,1,0,0,1,0.0,1,0,0,0,0,1,0,0
Girona,Iker Almena,es ESP,"FW,DF",20.0,0.5,0,0,0,0,0,0,1,0.0,1,1,0,1,0,0,2,0
Girona,Papa Ba,es ESP,MF,19.0,0.5,1,1,1,0,0,0,0,,0,1,0,1,0,1,1,0
Girona,Pau López,es ESP,GK,29.0,0.5,0,0,0,0,0,0,0,,0,0,0,0,0,0,1,0
Girona,Kim Minsu,kr KOR,MF,18.0,0.2,1,0,0,1,0,0,0,,0,0,0,0,0,1,0,0
Girona,Ferrán Ruiz,es ESP,MF,21.0,0.2,0,0,0,0,0,0,0,,0,2,1,1,1,1,0,0
Sevilla,Dodi Lukebakio,be BEL,FW,26.0,34.5,22,14,8,8,6,15,27,55.6,12,18,1,17,11,33,17,2
Sevilla,Carmona,es ESP,DF,22.0,32.8,83,59,53,21,9,41,77,53.2,36,37,11,26,68,151,92,3
Sevilla,Loïc Bade,fr FRA,DF,24.0,29.9,47,27,37,10,0,23,31,74.2,8,22,13,9,29,76,162,2
Sevilla,Ørjan Nyland,no NOR,GK,33.0,29.7,3,2,3,0,0,3,5,60.0,2,0,0,0,0,3,12,4
Sevilla,Nemanja Gudelj,rs SRB,MF,32.0,27.8,42,24,16,22,4,21,35,60.0,14,27,10,17,27,69,94,1
Sevilla,Adrià Pedrosa,es ESP,DF,26.0,25.6,56,32,34,16,6,31,54,57.4,23,43,11,32,24,80,85,0
Sevilla,Isaac Romero,es ESP,FW,24.0,24.2,13,7,4,4,5,3,16,18.8,13,18,1,17,7,20,27,0
Sevilla,Kike Salas,es ESP,DF,22.0,24.9,47,28,24,16,7,27,46,58.7,19,26,14,12,32,79,146,0
Sevilla,Lucien Agoume,fr FRA,MF,22.0,23.6,70,32,23,37,10,27,39,69.2,12,30,11,19,41,111,42,0
Sevilla,Djibril Sow,ch SUI,MF,27.0,23.1,25,14,13,10,2,8,17,47.1,9,18,3,15,28,53,26,1
Sevilla,Juanlu Sánchez,es ESP,MF,20.0,19.3,50,34,28,15,7,35,59,59.3,24,27,2,25,17,67,19,0
Sevilla,Saúl Ñíguez,es ESP,MF,29.0,17.3,47,32,16,24,7,12,31,38.7,19,25,2,23,22,69,34,0
Sevilla,Albert Sambi Lokonga,be BEL,MF,24.0,16.4,22,15,10,9,3,10,14,71.4,4,13,1,12,9,31,24,3
Sevilla,Peque,es ESP,MF,21.0,12.7,16,5,4,10,2,7,17,41.2,10,16,0,16,8,24,5,0
Sevilla,Chidera Ejuke,ng NGA,FW,26.0,10.8,19,13,8,9,2,9,20,45.0,11,12,0,12,5,24,8,0
Sevilla,Ruben Vargas,ch SUI,FW,25.0,7.6,7,4,1,5,1,3,8,37.5,5,9,0,9,3,10,10,0
Sevilla,Álvaro Fernández,es ESP,GK,26.0,8.3,0,0,0,0,0,0,1,0.0,1,0,0,0,0,0,7,0
Sevilla,Marcão,br BRA,DF,28.0,6.2,10,7,6,4,0,3,5,60.0,2,9,6,3,7,17,29,1
Sevilla,Tanguy Nianzou,fr FRA,DF,22.0,5.8,7,5,6,0,1,5,6,83.3,1,1,0,1,8,15,27,0
Sevilla,Kelechi Iheanacho,ng NGA,FW,27.0,4.5,1,0,0,1,0,1,3,33.3,2,0,0,0,0,1,1,0
Sevilla,Suso,es ESP,FW,30.0,6.8,10,7,3,6,1,4,11,36.4,7,4,0,4,4,14,2,0
Sevilla,Álvaro Pascual,es ESP,FW,22.0,4.6,5,3,0,3,2,1,5,20.0,4,4,0,4,2,7,9,0
Sevilla,Jesús Navas,es ESP,FW,38.0,4.7,5,2,3,0,2,0,3,0.0,3,1,0,1,4,9,6,0
Sevilla,Valentín Barco,ar ARG,DF,20.0,3.2,15,9,8,3,4,12,15,80.0,3,0,0,0,2,17,5,0
Sevilla,Stanis Idumbo,be BEL,FW,19.0,3.2,9,5,3,4,2,3,5,60.0,2,3,1,2,4,13,2,0
Sevilla,Ramón Martínez,es ESP,DF,21.0,2.9,6,3,5,1,0,3,5,60.0,2,2,1,1,2,8,23,0
Sevilla,Lucas Ocampos,ar ARG,FW,30.0,2.0,3,2,2,0,1,1,2,50.0,1,2,0,2,0,3,2,0
Sevilla,Manu Bueno,es ESP,MF,20.0,1.6,4,3,0,1,3,1,2,50.0,1,0,0,0,0,4,2,0
Sevilla,Akor Adams,ng NGA,FW,24.0,1.5,0,0,0,0,0,0,0,,0,1,0,1,0,0,1,0
Sevilla,Gonzalo Montiel,ar ARG,DF,27.0,1.3,4,2,3,1,0,3,4,75.0,1,0,0,0,2,6,11,0
Sevilla,Diego Iturralde,es ESP,FW,21.0,0.4,0,0,0,0,0,0,0,,0,0,0,0,1,1,1,0
Sevilla,Leandro Antonetti,pr PUR,FW,21.0,0.3,0,0,0,0,0,0,0,,0,0,0,0,0,0,0,0
Sevilla,Israel Domínguez,es ESP,FW,21.0,0.2,0,0,0,0,0,0,0,,0,0,0,0,0,0,0,0
Sevilla,Mateo Mejía,es ESP,FW,21.0,0.1,0,0,0,0,0,0,0,,0,0,0,0,0,0,0,0
Sevilla,Darío Fuentes,es ESP,DF,21.0,0.1,0,0,0,0,0,0,0,,0,0,0,0,0,0,0,0
Leganes,Sergi,es ESP,DF,32.0,32.9,40,29,22,16,2,18,32,56.3,14,38,29,9,39,79,185,2
Leganes,Marko Dmitrović,rs SRB,GK,32.0,32.0,1,1,1,0,0,1,2,50.0,1,0,0,0,0,1,27,3
Leganes,Seydouba Cissé,gn GUI,MF,23.0,27.3,59,37,18,27,14,23,50,46.0,27,25,1,24,12,71,45,1
Leganes,Valentin Rosier,fr FRA,DF,27.0,28.8,72,52,48,16,8,43,68,63.2,25,40,15,25,52,124,149,2
Leganes,Renato Tapia,pe PER,MF,29.0,27.0,61,35,30,27,4,24,50,48.0,26,58,23,35,27,88,86,2
Leganes,Javi Hernández,es ESP,DF,26.0,26.6,26,15,16,7,3,17,46,37.0,29,25,5,20,23,49,98,0
Leganes,Yvan Neyou,cm CMR,MF,27.0,25.8,53,33,21,26,6,22,47,46.8,25,35,5,30,26,79,38,1
Leganes,Juan Cruz,es ESP,FW,24.0,25.2,32,19,14,16,2,17,35,48.6,18,18,2,16,13,45,31,0
Leganes,Matija Nastasić,rs SRB,DF,31.0,23.5,25,11,21,4,0,17,25,68.0,8,39,30,9,21,46,165,0
Leganes,Dani Raba,es ESP,FW,28.0,21.1,37,23,17,15,5,17,42,40.5,25,27,3,24,14,51,19,1
Leganes,Jorge Sáenz,es ESP,DF,27.0,18.8,37,23,18,18,1,11,20,55.0,9,26,17,9,25,62,161,0
Leganes,Adrià Altimira,es ESP,DF,23.0,18.2,41,24,26,12,3,24,40,60.0,16,15,6,9,15,56,54,2
Leganes,Miguel,es ESP,FW,24.0,19.3,16,7,6,4,6,4,14,28.6,10,15,4,11,4,20,23,1
Leganes,Darko Brašanac,rs SRB,MF,32.0,18.1,26,11,5,15,6,9,17,52.9,8,24,11,13,16,42,34,0
Leganes,Diego,es ESP,FW,24.0,13.4,1,1,0,0,1,1,7,14.3,6,4,1,3,2,3,11,0
Leganes,Óscar Rodríguez Arnaiz,es ESP,MF,26.0,14.8,32,17,10,16,6,14,32,43.8,18,10,1,9,20,52,20,0
Leganes,Munir El Haddadi,ma MAR,FW,28.0,9.7,12,9,5,4,3,3,12,25.0,9,8,1,7,1,13,1,1
Leganes,Enric Franquesa,es ESP,DF,27.0,6.9,17,9,9,6,2,9,13,69.2,4,7,1,6,5,22,12,0
Leganes,Yan Diomandé,ci CIV,MF,17.0,6.1,14,9,1,8,5,5,15,33.3,10,8,0,8,8,22,6,0
Leganes,Juan Soriano,es ESP,GK,26.0,6.0,1,1,1,0,0,1,1,100.0,0,0,0,0,0,1,2,0
Leganes,Sébastien Haller,ci CIV,FW,30.0,4.5,2,0,1,0,1,1,2,50.0,1,1,0,1,0,2,7,0
Leganes,Roberto López,es ESP,MF,24.0,4.4,8,6,4,4,0,5,15,33.3,10,5,0,5,1,9,7,2
Leganes,Julián Chicco,ar ARG,MF,26.0,3.4,11,7,3,6,2,5,8,62.5,3,2,0,2,4,15,10,0
Leganes,Aritz Arambarri,es ESP,DF,26.0,2.0,1,1,1,0,0,1,1,100.0,0,2,2,0,3,4,8,0
Leganes,Duk,cv CPV,MF,24.0,2.0,8,4,3,3,2,3,5,60.0,2,4,0,4,1,9,2,0
Leganes,Borna Barišić,hr CRO,DF,31.0,0.1,0,0,0,0,0,0,0,,0,0,0,0,0,0,0,0
Las Palmas,Alberto Moleiro,es ESP,FW,20.0,30.3,27,12,12,14,1,18,48,37.5,30,24,0,24,18,45,8,0
Las Palmas,Álex Suárez,es ESP,DF,31.0,27.4,40,23,30,9,1,20,27,74.1,7,39,24,15,13,53,107,2
Las Palmas,Javier Muñoz,es ESP,MF,29.0,28.8,45,35,18,17,10,16,46,34.8,30,27,4,23,31,76,39,3
Las Palmas,Scott McKenna,sct SCO,DF,27.0,27.4,21,13,16,5,0,9,12,75.0,3,36,28,8,9,30,163,2
Las Palmas,Mika Mármol,es ESP,DF,23.0,26.7,61,29,35,24,2,34,52,65.4,18,46,14,32,38,99,121,2
Las Palmas,Jasper Cillessen,nl NED,GK,35.0,26.0,1,0,1,0,0,1,4,25.0,3,0,0,0,0,1,11,2
Las Palmas,Sandro Ramírez,es ESP,FW,29.0,22.8,27,15,10,13,4,13,30,43.3,17,20,0,20,16,43,22,2
Las Palmas,Dario Essugo,pt POR,MF,19.0,21.7,59,45,28,26,5,28,46,60.9,18,28,11,17,42,101,47,7
Las Palmas,Viti,es ESP,DF,26.0,22.1,71,46,43,21,7,31,45,68.9,14,28,7,21,27,98,61,0
Las Palmas,Fábio Silva,pt POR,FW,22.0,20.9,12,7,4,5,3,4,14,28.6,10,12,0,12,4,16,27,0
Las Palmas,Kirian Rodríguez,es ESP,MF,28.0,19.7,33,17,12,18,3,22,43,51.2,21,22,4,18,10,43,21,0
Las Palmas,Oliver McBurnie,sct SCO,FW,28.0,20.5,15,7,5,8,2,5,12,41.7,7,15,5,10,6,21,24,0
Las Palmas,Álex Muñoz,es ESP,DF,30.0,15.8,39,29,22,16,1,21,38,55.3,17,28,11,17,16,55,69,0
Las Palmas,Juan Herzog,es ESP,DF,21.0,14.6,12,12,12,0,0,9,16,56.3,7,17,11,6,18,30,86,0
Las Palmas,José Campaña,es ESP,MF,31.0,13.4,21,16,8,11,2,11,20,55.0,9,9,1,8,19,40,19,2
Las Palmas,Stefan Bajcetic,es ESP,MF,19.0,10.8,29,14,13,13,3,12,28,42.9,16,25,4,21,15,44,26,1
Las Palmas,Dinko Horkaš,hr CRO,GK,25.0,12.1,0,0,0,0,0,0,0,,0,0,0,0,0,0,9,1
Las Palmas,Marvin,es ESP,DF,24.0,11.6,25,13,12,9,4,11,26,42.3,15,17,6,11,15,40,34,0
Las Palmas,Manuel Fuster,es ESP,FW,26.0,11.2,19,11,5,8,6,15,28,53.6,13,13,3,10,4,23,17,0
Las Palmas,Enzo Loiodice,fr FRA,MF,23.0,7.6,17,7,8,9,0,3,10,30.0,7,4,1,3,10,27,7,2
Las Palmas,Adnan Januzaj,be BEL,MF,29.0,6.7,10,6,1,6,3,5,9,55.6,4,6,0,6,2,12,3,0
Las Palmas,Jaime Mata,es ESP,FW,35.0,7.3,8,2,2,6,0,3,9,33.3,6,5,1,4,3,11,11,0
Las Palmas,Benito Ramírez,es ESP,DF,29.0,5.3,10,5,4,6,0,9,16,56.3,7,8,3,5,1,11,14,1
Las Palmas,Andy Pelmard,fr FRA,DF,24.0,2.3,5,0,3,2,0,4,5,80.0,1,3,1,2,2,7,20,0
Las Palmas,Sergio Viera,es ESP,MF,19.0,1.1,1,1,0,1,0,0,1,0.0,1,1,0,1,1,2,1,0
Las Palmas,Daley Sinkgraven,nl NED,DF,29.0,1.0,5,1,3,2,0,1,3,33.3,2,1,0,1,1,6,2,0
Las Palmas,Marc Cardona,es ESP,"FW,DF",29.0,1.5,4,2,1,3,0,0,1,0.0,1,0,0,0,0,4,0,0
Las Palmas,Fabio González,es ESP,MF,27.0,0.6,0,0,0,0,0,0,1,0.0,1,0,0,0,0,0,0,0
Las Palmas,Diego Martín,es ESP,FW,20.0,0.4,1,1,0,0,1,1,1,100.0,0,0,0,0,0,1,1,0
Las Palmas,Arturo Rodríguez,es ESP,FW,17.0,0.2,0,0,0,0,0,0,0,,0,0,0,0,0,0,0,0
Las Palmas,Pejiño,es ESP,FW,28.0,0.2,1,1,0,1,0,1,1,100.0,0,0,0,0,0,1,0,0
Las Palmas,José Carlos González,es ESP,DF,18.0,0.1,0,0,0,0,0,0,0,,0,0,0,0,0,0,0,0
Las Palmas,Valentín Pezzolesi,es ESP,DF,17.0,0.1,0,0,0,0,0,0,0,,0,0,0,0,0,0,1,1
Las Palmas,Aboubacar Bassinga,ci CIV,MF,19.0,0.0,0,0,0,0,0,0,0,,0,0,0,0,0,0,0,0
Valladolid,Karl Jakob Hein,ee EST,GK,22.0,31.0,0,0,0,0,0,0,2,0.0,2,0,0,0,0,0,19,2
Valladolid,Luis Pérez,es ESP,DF,29.0,28.4,41,30,25,11,5,24,40,60.0,16,26,9,17,29,70,86,0
Valladolid,Raúl Moro,es ESP,MF,21.0,26.1,22,13,15,4,3,13,32,40.6,19,8,0,8,10,32,20,1
Valladolid,Javi Sánchez,es ESP,DF,27.0,22.6,26,16,19,6,1,17,26,65.4,9,39,28,11,22,48,111,3
Valladolid,Lucas Oliveira Rosa,br BRA,DF,24.0,21.0,53,33,40,11,2,35,51,68.6,16,24,9,15,28,81,69,2
Valladolid,Eray Cömert,ch SUI,DF,26.0,19.8,24,14,15,9,0,12,21,57.1,9,28,15,13,24,48,75,2
Valladolid,Anuar,ma MAR,MF,29.0,19.2,38,27,21,12,5,15,28,53.6,13,24,8,16,18,56,26,1
Valladolid,Mario Martín,es ESP,MF,20.0,19.5,62,32,31,27,4,21,49,42.9,28,32,7,25,21,83,46,7
Valladolid,Stanko Jurić,hr CRO,MF,27.0,19.3,48,24,26,19,3,19,48,39.6,29,35,11,24,24,72,52,0
Valladolid,Selim Amallah,ma MAR,MF,27.0,15.4,30,18,10,18,2,10,18,55.6,8,24,2,22,14,44,5,1
Valladolid,Mamadou Sylla,sn SEN,FW,30.0,17.7,8,4,3,3,2,2,9,22.2,7,8,0,8,3,11,14,1
Valladolid,David Torres,es ESP,DF,21.0,15.4,13,8,12,1,0,7,11,63.6,4,19,17,2,10,23,74,0
Valladolid,Juanmi Latasa,es ESP,FW,23.0,15.6,4,2,1,1,2,2,6,33.3,4,4,1,3,0,4,11,1
Valladolid,Kike Pérez,es ESP,MF,27.0,13.4,37,26,15,19,3,15,26,57.7,11,16,4,12,7,44,18,0
Valladolid,Marcos André,br BRA,FW,27.0,13.3,10,6,3,5,2,5,13,38.5,8,18,2,16,3,13,10,0
Valladolid,Antonio Candela,it ITA,DF,24.0,10.1,9,6,6,2,1,4,11,36.4,7,11,6,5,6,15,33,0
Valladolid,Iván Sánchez,es ESP,MF,31.0,15.7,37,20,18,10,9,12,27,44.4,15,18,3,15,14,51,10,0
Valladolid,Adam Aznou,ma MAR,DF,18.0,9.7,28,21,20,8,0,21,43,48.8,22,24,8,16,10,38,30,0
Valladolid,Juma Bah,sl SLE,DF,18.0,9.6,10,7,7,3,0,3,5,60.0,2,15,8,7,12,22,60,0
Valladolid,Tamás Nikitscher,hu HUN,MF,24.0,9.5,17,8,8,9,0,8,13,61.5,5,17,4,13,11,28,16,1
Valladolid,Chuky san jose,es ESP,MF,20.0,8.2,8,2,3,3,2,2,9,22.2,7,4,1,3,0,8,4,0
Valladolid,Cenk Özkacar,tr TUR,DF,23.0,8.4,9,5,7,2,0,4,14,28.6,10,9,6,3,18,27,69,1
Valladolid,Darwin Machís,ve VEN,MF,31.0,7.2,5,4,3,2,0,3,9,33.3,6,3,0,3,5,10,13,0
Valladolid,Florian Grillitsch,at AUT,MF,28.0,7.0,11,7,7,3,1,7,15,46.7,8,12,2,10,4,15,5,1
Valladolid,Joseph Aidoo,gh GHA,DF,28.0,6.5,5,5,3,2,0,2,3,66.7,1,8,4,4,5,10,26,1
Valladolid,André Ferreira,pt POR,GK,28.0,6.0,0,0,0,0,0,0,0,,0,0,0,0,0,0,4,2
Valladolid,Amath,sn SEN,"FW,DF",28.0,4.2,2,0,2,0,0,1,8,12.5,7,7,1,6,2,4,6,0
Valladolid,Henrique,br BRA,DF,30.0,3.9,6,2,3,2,1,1,4,25.0,3,5,0,5,3,9,12,0
Valladolid,Enzo Boyomo,cm CMR,DF,22.0,3.0,6,2,4,2,0,3,3,100.0,0,4,3,1,1,7,7,0
Valladolid,Víctor Meseguer,es ESP,MF,25.0,4.7,10,6,4,4,2,2,10,20.0,8,3,0,3,2,12,4,1
Valladolid,Ibrahim Alani,ng NGA,MF,18.0,1.8,12,7,8,4,0,4,6,66.7,2,3,1,2,1,13,1,0
Valladolid,Raúl Chasco,es ESP,DF,20.0,1.4,4,1,3,1,0,2,4,50.0,2,1,0,1,2,6,2,0
Valladolid,Arnau Rafús,es ESP,GK,21.0,1.0,0,0,0,0,0,0,0,,0,0,0,0,0,0,0,1
Valladolid,Iago Parente,es ESP,DF,18.0,0.8,0,0,0,0,0,0,0,,0,0,0,0,0,0,2,0
Valladolid,Xavier Moreno,es ESP,FW,19.0,0.5,0,0,0,0,0,0,0,,0,0,0,0,0,0,1,0
Valladolid,Mario Maroto,es ESP,MF,20.0,0.7,0,0,0,0,0,0,2,0.0,2,0,0,0,2,2,2,0
Valladolid,Adrian Baquerin,es ESP,FW,17.0,0.5,1,1,0,1,0,0,0,,0,0,0,0,0,1,1,0
Valladolid,Kenedy,br BRA,MF,28.0,0.1,0,0,0,0,0,0,0,,0,1,0,1,0,0,0,0
Genk,Jarne Steuckers,be BEL,FW,22.0,28.4,20,11,10,8,2,8,26,30.8,18,10,1,9,10,30,11,0
Genk,Matte Smets,be BEL,DF,20.0,27.6,44,26,29,14,1,23,34,67.6,11,41,25,16,50,94,122,2
Genk,Tolu Arokodare,ng NGA,FW,23.0,25.9,16,8,3,7,6,5,14,35.7,9,9,2,7,4,20,35,1
Genk,Joris Kayembe,cd COD,DF,29.0,27.2,51,35,35,12,4,24,37,64.9,13,26,7,19,42,93,68,1
Genk,Mujaid Sadick,es ESP,DF,24.0,26.7,56,36,30,23,3,25,32,78.1,7,38,28,10,21,77,106,1
Genk,Bryan Heynen,be BEL,MF,27.0,26.2,54,32,21,28,5,21,42,50.0,21,41,11,30,39,93,82,2
Genk,Zakaria El Ouahdi,ma MAR,DF,22.0,25.7,56,34,34,14,8,31,69,44.9,38,47,14,33,28,84,73,0
Genk,Christopher Bonsu-Baah,gh GHA,FW,19.0,20.3,35,23,10,18,7,14,24,58.3,10,13,0,13,10,45,14,0
Genk,Hendrik Van Crombrugge,be BEL,GK,31.0,19.0,0,0,0,0,0,0,1,0.0,1,0,0,0,0,0,11,3
Genk,Patrik Hrošovský,sk SVK,MF,32.0,18.9,24,15,6,14,4,13,25,52.0,12,12,1,11,4,28,21,0
Genk,Ibrahima Sory Bangoura,gn GUI,MF,20.0,14.1,60,38,22,30,8,23,34,67.6,11,21,5,16,27,87,13,0
Genk,Konstantinos Karetsas,gr GRE,MF,16.0,13.0,17,7,5,3,9,9,21,42.9,12,14,1,13,0,17,7,0
Genk,Nikolas Sattlberger,at AUT,MF,20.0,12.5,29,15,11,16,2,14,34,41.2,20,11,1,10,15,44,27,0
Genk,Mike Penders,be BEL,GK,19.0,11.0,1,1,1,0,0,0,0,,0,1,0,1,0,1,4,0
Genk,Carlos Cuesta,co COL,DF,25.0,6.8,13,11,7,6,0,4,6,66.7,2,7,4,3,4,17,17,1
Genk,Yira Sor,ng NGA,FW,24.0,6.7,7,4,4,3,0,0,3,0.0,3,4,0,4,4,11,1,0
Genk,Noah Adedeji,be BEL,FW,19.0,5.9,15,7,5,3,7,4,9,44.4,5,9,0,9,10,25,7,0
Genk,Ken Nkuba,be BEL,DF,22.0,5.2,13,9,9,2,2,3,13,23.1,10,7,1,6,5,18,10,0
Genk,Oh Hyeon-gyu,kr KOR,FW,23.0,4.9,6,4,2,3,1,2,5,40.0,3,2,0,2,0,6,4,0
Genk,Alieu Fadera,gm GAM,MF,22.0,2.0,11,10,7,1,3,3,7,42.9,4,4,0,4,2,13,0,1
Genk,Josué Kongolo,be BEL,DF,18.0,0.9,3,3,0,3,0,1,1,100.0,0,0,0,0,2,5,5,0
Genk,Bilal El Khannouss,ma MAR,MF,20.0,0.8,2,1,1,0,1,0,0,,0,1,0,1,0,2,3,0
Genk,Andi Zeqiri,ch SUI,MF,25.0,0.5,0,0,0,0,0,0,0,,0,0,0,0,0,0,0,0
Genk,Luca Oyen,be BEL,FW,21.0,0.0,0,0,0,0,0,0,0,,0,0,0,0,0,0,1,0
Genk,Mark McKenzie,us USA,FW,25.0,0.0,0,0,0,0,0,0,0,,0,0,0,0,0,0,0,0
Club Brugge,Brandon Mechele,be BEL,DF,31.0,30.0,49,32,29,17,3,21,36,58.3,15,44,24,20,39,88,136,2
Club Brugge,Simon Mignolet,be BEL,GK,36.0,29.7,2,1,2,0,0,2,4,50.0,2,1,0,1,0,2,11,2
Club Brugge,Hans Vanaken,be BEL,MF,31.0,28.7,36,17,13,16,7,11,32,34.4,21,30,3,27,11,47,40,1
Club Brugge,Christos Tzolis,gr GRE,FW,22.0,23.0,24,13,10,6,8,9,22,40.9,13,28,1,27,14,38,16,1
Club Brugge,Maxim De Cuyper,be BEL,DF,23.0,24.6,50,33,33,13,4,21,37,56.8,16,28,5,23,17,67,58,2
Club Brugge,Joaquin Seys,be BEL,DF,19.0,19.4,63,38,30,25,8,25,40,62.5,15,18,6,12,24,87,53,0
Club Brugge,Ardon Jashari,ch SUI,MF,22.0,21.0,27,16,11,14,2,10,30,33.3,20,15,4,11,20,47,30,0
Club Brugge,Raphael Onyedika,ng NGA,MF,23.0,18.8,34,17,9,22,3,15,36,41.7,21,22,4,18,15,49,20,3
Club Brugge,Joel Ordóñez,ec ECU,DF,20.0,19.3,18,12,11,7,0,6,12,50.0,6,14,11,3,18,36,99,1
Club Brugge,Gustaf Nilsson,se SWE,FW,27.0,17.3,14,9,3,6,5,5,8,62.5,3,12,3,9,2,16,12,0
Club Brugge,Hugo Vetlesen,no NOR,MF,24.0,13.0,20,15,7,9,4,8,16,50.0,8,10,2,8,10,30,19,0
Club Brugge,Andreas Skov Olsen,dk DEN,FW,24.0,12.8,8,6,2,4,2,5,16,31.3,11,7,2,5,5,13,11,0
Club Brugge,Chemsdine Talbi,be BEL,FW,19.0,10.7,15,11,8,5,2,6,11,54.5,5,2,0,2,7,22,8,0
Club Brugge,Ferran Jutglà,es ESP,FW,25.0,12.5,16,8,3,8,5,6,13,46.2,7,10,2,8,3,19,12,0
Club Brugge,Kyriani Sabbe,be BEL,DF,19.0,7.7,25,16,14,5,6,18,27,66.7,9,13,3,10,9,34,17,0
Club Brugge,Romeo Vermant,be BEL,FW,20.0,7.4,12,9,2,7,3,5,9,55.6,4,3,0,3,1,13,3,0
Club Brugge,Zaid Romero,ar ARG,DF,24.0,6.6,13,8,8,5,0,8,10,80.0,2,7,4,3,8,21,23,1
Club Brugge,Casper Nielsen,dk DEN,MF,30.0,5.7,7,5,3,3,1,3,9,33.3,6,6,3,3,6,13,9,0
Club Brugge,Jorne Spileers,be BEL,DF,19.0,5.6,6,4,2,4,0,3,5,60.0,2,7,7,0,2,8,29,1
Club Brugge,Michał Skóraś,pl POL,FW,24.0,7.2,17,11,7,5,5,7,12,58.3,5,7,0,7,3,20,9,0
Club Brugge,Hugo Siquet,be BEL,DF,22.0,5.0,13,8,8,4,1,9,22,40.9,13,9,1,8,3,16,17,0
Club Brugge,Bjorn Meijer,nl NED,DF,21.0,2.6,4,2,1,3,0,0,2,0.0,2,4,0,4,0,4,5,0
Club Brugge,Antonio Nusa,no NOR,FW,19.0,1.8,2,1,1,0,1,2,3,66.7,1,0,0,0,0,2,1,0
Club Brugge,Nordin Jackers,be BEL,GK,26.0,0.3,0,0,0,0,0,0,0,,0,0,0,0,0,0,0,0
Club Brugge,Shandre Campbell,za RSA,FW,19.0,0.1,0,0,0,0,0,0,0,,0,0,0,0,0,0,0,0
Union SG,Anthony Moris,lu LUX,GK,34.0,30.0,0,0,0,0,0,0,1,0.0,1,0,0,0,0,0,16,2
Union SG,Noah Sadiki,cd COD,MF,19.0,27.0,48,26,19,20,9,18,37,48.6,19,36,6,30,29,77,36,0
Union SG,Kevin Mac Allister,ar ARG,DF,26.0,22.6,77,49,39,33,5,46,82,56.1,36,37,12,25,43,120,96,0
Union SG,Charles Vanhoutte,be BEL,MF,25.0,22.6,56,41,20,30,6,30,58,51.7,28,39,9,30,30,86,55,0
Union SG,Koki Machida,jp JPN,DF,26.0,21.0,30,21,21,6,3,19,41,46.3,22,22,11,11,28,58,95,0
Union SG,Franjo Ivanović,hr CRO,FW,20.0,19.7,25,12,3,14,8,7,31,22.6,24,25,2,23,3,28,9,0
Union SG,Christian Burgess,eng ENG,DF,32.0,21.0,42,20,28,13,1,23,31,74.2,8,25,17,8,16,58,142,1
Union SG,Fedde Leysen,be BEL,DF,21.0,17.4,36,21,24,10,2,19,29,65.5,10,16,4,12,24,60,84,1
Union SG,Anan Khalaili,il ISR,DF,19.0,16.7,59,36,35,18,6,31,56,55.4,25,30,7,23,24,83,47,0
Union SG,Tobi David,ca CAN,FW,23.0,15.4,8,5,1,3,4,3,7,42.9,4,9,1,8,2,10,21,1
Union SG,Mohammed Fuseini,gh GHA,FW,22.0,14.4,8,6,4,2,2,1,11,9.1,10,8,0,8,6,14,4,0
Union SG,Anouar Ait El Hadj,be BEL,MF,22.0,12.1,25,17,6,12,7,12,24,50.0,12,10,0,10,4,29,6,0
Union SG,Ousseynou Niang,sn SEN,DF,22.0,11.9,30,24,11,16,3,14,41,34.1,27,32,2,30,9,39,8,1
Union SG,Alessio Castro-Montes,be BEL,DF,27.0,11.5,23,15,9,8,6,12,27,44.4,15,18,2,16,11,34,13,0
Union SG,Ross Sykes,eng ENG,DF,25.0,11.3,21,18,17,3,1,12,22,54.5,10,9,4,5,21,42,70,1
Union SG,Mathias Rasmussen,no NOR,MF,26.0,10.2,36,22,13,18,5,13,21,61.9,8,12,2,10,12,48,20,0
Union SG,Sofiane Boufal,ma MAR,MF,30.0,7.4,16,9,10,4,2,8,14,57.1,6,6,0,6,4,20,0,0
Union SG,Loïc Lapoussin,mg MAD,DF,28.0,5.9,8,3,3,3,2,4,15,26.7,11,14,1,13,9,17,12,0
Union SG,Kevin Rodríguez,ec ECU,FW,24.0,7.0,4,3,3,1,0,2,3,66.7,1,1,0,1,1,5,7,0
Union SG,Jean Thierry Lazare,ci CIV,MF,26.0,5.0,14,9,5,5,4,4,9,44.4,5,7,1,6,4,18,3,0
Union SG,Casper Terho,fi FIN,DF,21.0,4.9,9,5,4,5,0,6,19,31.6,13,7,1,6,7,16,11,0
Union SG,Kamiel Van De Perre,be BEL,MF,20.0,4.9,37,25,21,9,7,18,30,60.0,12,14,2,12,6,43,8,0
Union SG,Henok Teklab,de GER,DF,25.0,2.8,7,4,2,5,0,5,8,62.5,3,2,0,2,4,11,2,0
Union SG,Dennis Eckert,de GER,FW,27.0,2.2,1,0,0,0,1,0,1,0.0,1,3,1,2,0,1,0,0
Union SG,Cameron Puertas,ch SUI,MF,25.0,2.3,2,2,0,2,0,2,5,40.0,3,2,0,2,1,3,0,0
Union SG,Elton Kabangu,be BEL,FW,26.0,1.4,1,0,0,0,1,0,1,0.0,1,0,0,0,0,1,0,0
Union SG,Guillaume François,be BEL,DF,34.0,1.3,2,0,0,2,0,1,1,100.0,0,0,0,0,3,5,2,0
Union SG,Marc Giger,ch SUI,DF,20.0,0.2,1,0,0,1,0,1,2,50.0,1,0,0,0,1,2,0,0
Union SG,Mamadou Traoré,ml MLI,DF,22.0,0.2,0,0,0,0,0,0,1,0.0,1,1,0,1,0,0,1,0
Anderlecht,Colin Coosemans,be BEL,GK,31.0,28.0,1,1,1,0,0,1,3,33.3,2,0,0,0,1,2,17,3
Anderlecht,Mats Rits,be BEL,MF,31.0,22.7,26,18,9,12,5,17,36,47.2,19,36,15,21,19,45,58,0
Anderlecht,Jan-Carlo Simic,rs SRB,DF,19.0,22.1,17,9,9,8,0,6,9,66.7,3,25,21,4,25,42,86,1
Anderlecht,Killian Sardella,be BEL,DF,22.0,21.9,44,29,24,14,6,22,37,59.5,15,23,8,15,10,54,49,0
Anderlecht,Kasper Dolberg,dk DEN,FW,26.0,18.7,7,4,2,3,2,3,14,21.4,11,5,0,5,1,8,9,1
Anderlecht,Moussa N'Diaye,sn SEN,DF,22.0,18.1,38,21,22,11,5,18,29,62.1,11,13,1,12,24,62,63,3
Anderlecht,Leander Dendoncker,be BEL,MF,29.0,19.3,51,33,27,21,3,22,55,40.0,33,42,12,30,23,74,64,1
Anderlecht,Mario Stroeykens,be BEL,MF,19.0,17.1,43,22,17,15,11,14,30,46.7,16,11,2,9,10,53,4,1
Anderlecht,Yari Verschaeren,be BEL,MF,23.0,16.9,34,28,13,12,9,16,29,55.2,13,12,2,10,12,46,21,1
Anderlecht,Mathias Jørgensen,dk DEN,DF,34.0,15.7,21,15,14,7,0,15,21,71.4,6,21,16,5,16,37,66,1
Anderlecht,Anders Dreyer,dk DEN,FW,26.0,15.4,8,6,2,4,2,3,14,21.4,11,5,1,4,3,11,9,0
Anderlecht,Theo Leoni,be BEL,MF,24.0,15.2,26,18,11,11,4,18,34,52.9,16,10,0,10,19,45,26,0
Anderlecht,Samuel Edozie,eng ENG,FW,21.0,10.7,14,9,6,6,2,6,8,75.0,2,9,1,8,7,21,6,0
Anderlecht,Ludwig Augustinsson,se SWE,DF,30.0,9.5,23,18,9,11,3,11,16,68.8,5,7,4,3,12,35,31,0
Anderlecht,Francis Amuzu,be BEL,FW,24.0,8.0,10,8,5,3,2,5,12,41.7,7,1,0,1,3,13,3,0
Anderlecht,Thorgan Hazard,be BEL,FW,31.0,7.5,14,8,5,7,2,7,17,41.2,10,6,0,6,0,14,3,0
Anderlecht,Lucas Hey,dk DEN,DF,21.0,7.2,11,6,6,5,0,3,10,30.0,7,7,5,2,3,14,27,1
Anderlecht,César Huerta,mx MEX,MF,23.0,6.9,13,6,7,4,2,3,17,17.6,14,9,0,9,2,15,2,0
Anderlecht,Luis Vázquez,ar ARG,FW,23.0,10.3,13,7,1,6,6,5,10,50.0,5,8,1,7,0,13,16,0
Anderlecht,Adryelson,br BRA,DF,26.0,6.0,7,4,7,0,0,6,6,100.0,0,5,3,2,5,12,47,0
Anderlecht,Thomas Foket,be BEL,DF,29.0,5.8,12,5,8,3,1,7,12,58.3,5,9,4,5,5,17,18,0
Anderlecht,Ali Maamar,ma MAR,DF,19.0,4.7,12,6,8,3,1,6,9,66.7,3,4,1,3,2,14,11,0
Anderlecht,Tristan Degreef,be BEL,FW,19.0,4.2,14,8,2,9,3,8,14,57.1,6,2,0,2,3,17,4,0
Anderlecht,Nilson Angulo,ec ECU,"FW,DF",21.0,5.1,15,8,3,7,5,5,12,41.7,7,10,0,10,3,18,7,0
Anderlecht,Majeed Ashimeru,gh GHA,MF,26.0,4.3,9,7,5,3,1,2,5,40.0,3,1,0,1,6,15,5,0
Anderlecht,Jan Vertonghen,be BEL,DF,37.0,3.0,1,0,0,1,0,0,2,0.0,2,4,2,2,1,2,12,0
Anderlecht,Mads Kikkenborg,dk DEN,GK,24.0,2.0,0,0,0,0,0,0,0,,0,0,0,0,0,0,1,1
Anderlecht,Keisuke Goto,jp JPN,FW,19.0,1.7,2,1,0,1,1,0,2,0.0,2,2,1,1,0,2,0,0
Anderlecht,Amando Lapage,be BEL,DF,19.0,1.1,3,1,3,0,0,3,3,100.0,0,1,0,1,1,4,6,0
Anderlecht,Nunzio Engwanda,be BEL,DF,16.0,0.7,2,2,0,2,0,1,1,100.0,0,1,0,1,0,2,0,0
Anderlecht,Kristian Arnstad,no NOR,DF,20.0,0.3,0,0,0,0,0,0,0,,0,0,0,0,1,1,0,0
Anderlecht,Elyess Dao,ma MAR,MF,17.0,0.1,0,0,0,0,0,0,0,,0,0,0,0,0,0,0,0
Anderlecht,Alexis Flips,fr FRA,FW,24.0,0.0,0,0,0,0,0,0,0,,0,0,0,0,0,0,0,0
Anderlecht,Louis Patris,be BEL,DF,23.0,0.0,1,1,0,1,0,1,1,100.0,0,0,0,0,0,1,0,0
Antwerp,Senne Lammens,be BEL,GK,22.0,30.0,0,0,0,0,0,0,1,0.0,1,0,0,0,0,0,11,3
Antwerp,Zeno Van den Bosch,be BEL,DF,21.0,30.0,42,34,33,8,1,22,35,62.9,13,57,35,22,30,72,147,2
Antwerp,Tjaronn Chery,sr SUR,MF,36.0,26.5,20,13,11,6,3,7,17,41.2,10,6,0,6,4,24,7,2
Antwerp,Vincent Janssen,nl NED,FW,30.0,27.7,34,25,8,16,10,19,31,61.3,12,17,1,16,7,41,33,1
Antwerp,Gyrano Kerk,sr SUR,FW,28.0,26.0,41,31,16,17,8,19,50,38.0,31,23,1,22,7,48,13,1
Antwerp,Toby Alderweireld,be BEL,DF,35.0,27.0,17,10,15,2,0,9,22,40.9,13,38,27,11,22,39,136,4
Antwerp,Jelle Bataille,be BEL,DF,25.0,16.6,51,35,27,20,4,26,46,56.5,20,25,4,21,24,75,31,2
Antwerp,Mahamadou Doumbia,ml MLI,MF,20.0,18.5,41,25,16,22,3,12,29,41.4,17,24,8,16,18,59,31,5
Antwerp,Jacob Ondrejka,se SWE,FW,21.0,16.9,13,12,5,6,2,4,8,50.0,4,14,4,10,4,17,4,0
Antwerp,Denis Odoi,gh GHA,MF,36.0,16.0,27,17,10,10,7,13,21,61.9,8,13,5,8,15,42,41,3
Antwerp,Ayrton Costa,ar ARG,DF,25.0,13.5,43,27,26,12,5,25,44,56.8,19,21,5,16,32,75,43,1
Antwerp,Kobe Corbanie,be BEL,DF,19.0,13.1,28,21,14,11,3,16,24,66.7,8,13,8,5,15,43,29,1
Antwerp,Olivier Deman,be BEL,DF,24.0,9.9,37,25,23,6,8,14,28,50.0,14,12,2,10,10,47,38,0
Antwerp,Dennis Praet,be BEL,MF,30.0,9.3,25,15,8,16,1,9,13,69.2,4,12,2,10,10,35,23,0
Antwerp,Jaïro Riedewald,nl NED,DF,27.0,9.2,24,16,10,13,1,11,17,64.7,6,11,3,8,11,35,35,0
Antwerp,Anthony Valencia,ec ECU,"FW,DF",21.0,9.9,24,19,7,8,9,4,15,26.7,11,18,0,18,9,33,8,1
Antwerp,Semm Renders,be BEL,DF,16.0,6.2,10,6,5,5,0,3,5,60.0,2,7,2,5,6,16,23,0
Antwerp,Mauricio Benítez,ar ARG,MF,20.0,3.9,6,2,2,4,0,1,7,14.3,6,5,3,2,6,12,10,1
Antwerp,Andreas Verstraeten,be BEL,MF,18.0,5.1,12,8,4,4,4,8,20,40.0,12,4,0,4,5,17,9,0
Antwerp,Mohamed Lamine Bayo,gn GUI,FW,26.0,2.8,1,0,0,0,1,0,1,0.0,1,3,0,3,0,1,4,0
Antwerp,Mandela Keita,be BEL,MF,22.0,2.6,7,3,3,3,1,5,7,71.4,2,2,1,1,5,12,3,0
Antwerp,Michel-Ange Balikwisha,be BEL,MF,23.0,2.2,1,1,0,1,0,0,0,,0,6,0,6,4,5,0,0
Antwerp,Farouck Adekami,ci CIV,FW,17.0,1.4,2,1,0,1,1,1,3,33.3,2,1,0,1,0,2,2,0
Antwerp,Rosen Bozhinov,bg BUL,DF,19.0,1.3,3,3,2,1,0,1,1,100.0,0,3,2,1,3,6,6,1
Antwerp,Jurgen Ekkelenkamp,nl NED,MF,24.0,0.7,0,0,0,0,0,0,0,,0,0,0,0,0,0,1,0
Antwerp,Kadan Young,eng ENG,FW,18.0,0.7,2,1,1,1,0,1,1,100.0,0,2,0,2,1,3,2,0
Antwerp,Christopher Scott,de GER,MF,22.0,1.4,1,1,1,0,0,0,2,0.0,2,0,0,0,0,1,1,0
Antwerp,Victor Udoh,ng NGA,"FW,DF",19.0,1.0,1,1,0,1,0,1,1,100.0,0,1,0,1,0,1,0,0
Antwerp,Gerard Vandeplas,be BEL,MF,18.0,0.4,1,0,0,1,0,0,0,,0,1,0,1,0,1,1,0
Antwerp,Milo Horemans,be BEL,MF,18.0,0.3,0,0,0,0,0,0,0,,0,0,0,0,1,1,0,0
Antwerp,Milan Smits,be BEL,MF,19.0,0.3,0,0,0,0,0,0,1,0.0,1,0,0,0,0,0,0,0
Antwerp,Orseer Achihi,ng NGA,FW,17.0,0.3,0,0,0,0,0,0,0,,0,0,0,0,0,0,0,0
Antwerp,Youssef Hamdaoui,be BEL,DF,16.0,0.1,0,0,0,0,0,0,1,0.0,1,1,0,1,0,0,0,0
Antwerp,Alhassan Yusuf,ng NGA,MF,24.0,0.1,0,0,0,0,0,0,1,0.0,1,0,0,0,0,0,0,0
Antwerp,Gabriel David,ng NGA,MF,17.0,0.1,0,0,0,0,0,0,0,,0,0,0,0,0,0,0,0
Antwerp,Alexandre Stanic,be BEL,FW,19.0,0.0,0,0,0,0,0,0,0,,0,0,0,0,0,0,0,0
Gent,Mathias Delorge,be BEL,MF,20.0,26.6,54,29,14,33,7,31,69,44.9,38,24,5,19,22,76,30,4
Gent,Tsuyoshi Watanabe,jp JPN,DF,27.0,26.9,36,20,24,11,1,18,24,75.0,6,40,32,8,28,64,174,2
Gent,Davy Roef,be BEL,GK,30.0,26.0,1,1,1,0,0,1,1,100.0,0,0,0,0,0,1,13,4
Gent,Archie Brown,eng ENG,DF,22.0,25.5,37,23,21,12,4,14,27,51.9,13,35,5,30,28,65,70,2
Gent,Jordan Torunarigha,de GER,DF,26.0,20.6,37,20,24,12,1,17,21,81.0,4,31,16,15,31,68,124,0
Gent,Atsuki Ito,jp JPN,MF,25.0,21.3,60,38,20,27,13,29,53,54.7,24,32,7,25,23,83,54,1
Gent,Omri Gandelman,il ISR,MF,24.0,16.9,38,22,9,19,10,16,27,59.3,11,19,4,15,8,46,14,1
Gent,Franck Surdez,ch SUI,MF,22.0,13.7,27,16,4,12,11,8,26,30.8,18,14,0,14,5,32,7,0
Gent,Hugo Gambor,cf CTA,DF,21.0,13.6,38,25,17,16,5,17,22,77.3,5,15,2,13,24,62,23,0
Gent,Andri Guðjohnsen,is ISL,FW,22.0,14.1,12,8,0,7,5,3,9,33.3,6,9,2,7,0,12,9,0
Gent,Stefan Mitrović,rs SRB,DF,34.0,13.9,20,12,16,4,0,18,23,78.3,5,19,14,5,13,33,63,1
Gent,Matisse Samoise,be BEL,DF,22.0,13.9,48,32,25,15,8,27,40,67.5,13,20,8,12,25,73,41,2
Gent,Momodou Sonko,se SWE,"FW,DF",19.0,13.0,24,15,10,11,3,6,24,25.0,18,13,0,13,11,35,5,1
Gent,Max Dean,eng ENG,FW,20.0,10.9,6,3,1,2,3,3,10,30.0,7,2,0,2,2,8,4,0
Gent,Noah Fadiga,sn SEN,DF,24.0,9.4,12,8,5,5,2,5,6,83.3,1,11,1,10,5,17,10,0
Gent,Sven Kums,be BEL,MF,36.0,10.0,19,10,7,7,5,8,21,38.1,13,9,3,6,5,24,25,1
Gent,Pieter Gerkens,be BEL,MF,28.0,7.8,11,9,3,6,2,4,17,23.5,13,13,3,10,13,24,19,1
Gent,Leonardo da Silva Lopes,pt POR,MF,25.0,7.1,19,14,7,11,1,4,13,30.8,9,15,3,12,7,26,10,0
Gent,Dante Vanzeir,be BEL,FW,26.0,6.7,4,3,0,2,2,3,4,75.0,1,3,0,3,0,4,0,0
Gent,Andrew Hjulsager,dk DEN,FW,29.0,5.0,12,9,1,9,2,3,11,27.3,8,5,0,5,2,14,0,0
Gent,Tiago Araújo,pt POR,DF,23.0,6.5,13,11,7,2,4,6,21,28.6,15,11,2,9,0,13,18,0
Gent,Samuel Kotto,cm CMR,DF,20.0,3.4,3,3,3,0,0,2,2,100.0,0,6,3,3,4,7,15,0
Gent,Tom Vandenberghe,be BEL,GK,31.0,3.0,0,0,0,0,0,0,0,,0,0,0,0,0,0,3,0
Gent,Hong Hyunseok,kr KOR,MF,25.0,2.8,4,2,2,2,0,1,6,16.7,5,2,0,2,1,5,1,0
Gent,Daisuke Yokota,jp JPN,MF,24.0,2.6,4,1,2,2,0,2,3,66.7,1,0,0,0,0,4,2,0
Gent,Hyllarion Goore,ci CIV,FW,18.0,2.3,4,2,1,2,1,1,2,50.0,1,1,0,1,0,4,1,0
Gent,Matias Fernandez-Pardo,be BEL,MF,19.0,1.8,0,0,0,0,0,0,2,0.0,2,2,0,2,0,0,0,0
Gent,Daniel Schmidt,jp JPN,GK,32.0,1.0,1,0,1,0,0,0,0,,0,0,0,0,1,2,0,0
Gent,Zalán Vancsa,hu HUN,MF,19.0,1.0,0,0,0,0,0,0,1,0.0,1,1,0,1,0,0,1,0
Gent,Hélio Varela,cv CPV,FW,22.0,1.6,1,1,0,1,0,0,1,0.0,1,1,0,1,1,2,1,0
Gent,Aimé Omgba,nl NED,MF,21.0,0.6,2,2,2,0,0,1,1,100.0,0,1,0,1,1,3,5,0
Gent,Tibe De Vlieger,be BEL,"FW,DF",18.0,0.5,1,1,0,0,1,1,2,50.0,1,0,0,0,1,2,2,0
Gent,Gilles De Meyer,be BEL,DF,17.0,0.2,0,0,0,0,0,0,0,,0,0,0,0,1,1,0,0
Gent,Núrio Fortuna,ao ANG,MF,29.0,0.1,0,0,0,0,0,0,0,,0,0,0,0,0,0,1,0
Gent,Ismaël Kandouss,ma MAR,MF,26.0,0.0,0,0,0,0,0,0,0,,0,0,0,0,0,0,2,0
Gent,Ahmed Abdullahi,ng NGA,MF,20.0,0.0,1,0,0,1,0,0,0,,0,0,0,0,0,1,0,0
Standard Liege,Marlon Fossey,us USA,DF,25.0,28.1,30,21,17,11,2,11,20,55.0,9,21,5,16,42,72,123,0
Standard Liege,Ibe Hautekiet,be BEL,DF,22.0,24.0,50,31,34,14,2,16,26,61.5,10,21,11,10,41,91,168,1
Standard Liege,Aiden O'Neill,au AUS,MF,26.0,24.1,58,38,22,29,7,27,54,50.0,27,29,8,21,23,81,50,1
Standard Liege,Ilay Camara,sn SEN,DF,21.0,23.8,42,23,21,20,1,28,44,63.6,16,24,3,21,22,64,54,1
Standard Liege,Henry Lawrence,eng ENG,DF,22.0,23.1,34,18,23,10,1,17,30,56.7,13,28,18,10,33,67,113,1
Standard Liege,Léandre Kuavita,be BEL,MF,20.0,20.8,20,5,3,12,5,10,20,50.0,10,28,3,25,15,35,32,0
Standard Liege,Andi Zeqiri,ch SUI,FW,25.0,19.3,13,6,3,7,3,4,11,36.4,7,7,2,5,3,16,17,0
Standard Liege,Dennis Eckert,de GER,FW,27.0,20.1,27,16,8,16,3,8,20,40.0,12,13,2,11,6,33,23,0
Standard Liege,Isaac Price,nir NIR,MF,20.0,19.7,47,21,21,25,1,27,74,36.5,47,38,7,31,20,67,52,2
Standard Liege,Bosko Sutalo,hr CRO,DF,24.0,18.2,45,32,32,11,2,25,33,75.8,8,21,15,6,51,96,103,1
Standard Liege,Matthieu Epolo,be BEL,GK,20.0,18.5,1,1,1,0,0,1,2,50.0,1,0,0,0,0,1,13,2
Standard Liege,Marko Bulat,hr CRO,MF,22.0,14.2,26,20,9,10,7,10,23,43.5,13,12,5,7,14,40,17,0
Standard Liege,David Bates,sct SCO,DF,27.0,8.6,16,11,12,4,0,8,9,88.9,1,15,11,4,17,33,47,0
Standard Liege,Sotiris Alexandropoulos,gr GRE,MF,22.0,7.7,34,21,11,19,4,15,26,57.7,11,17,8,9,10,44,17,0
Standard Liege,Soufiane Benjdida,ma MAR,FW,22.0,6.3,2,1,0,2,0,2,4,50.0,2,5,0,5,2,4,6,0
Standard Liege,Gavin Bazunu,ie IRL,GK,22.0,6.0,1,1,1,0,0,1,1,100.0,0,0,0,0,0,1,7,0
Standard Liege,Daan Dierckx,be BEL,DF,21.0,5.9,6,4,4,1,1,2,5,40.0,3,15,11,4,7,13,43,0
Standard Liege,Jean Thierry Lazare,ci CIV,MF,26.0,5.4,17,9,6,8,3,8,16,50.0,8,7,1,6,2,19,4,0
Standard Liege,Ibrahim Karamoko,fr FRA,MF,23.0,5.0,9,6,5,3,1,1,5,20.0,4,8,2,6,7,16,21,0
Standard Liege,Nathan Ngoy,be BEL,DF,21.0,4.0,10,6,8,2,0,5,8,62.5,3,6,4,2,9,19,26,0
Standard Liege,Laurent Henkinet,be BEL,GK,31.0,3.5,0,0,0,0,0,0,0,,0,0,0,0,0,0,4,0
Standard Liege,Boli Bolingoli-Mbombo,be BEL,DF,29.0,5.3,17,11,9,5,3,10,19,52.6,9,8,4,4,3,20,14,0
Standard Liege,Attila Szalai,hu HUN,DF,26.0,2.7,4,3,4,0,0,3,5,60.0,2,2,1,1,5,9,22,0
Standard Liege,Andreas Hountondji,bj BEN,FW,22.0,3.5,0,0,0,0,0,0,2,0.0,2,1,0,1,0,0,4,0
Standard Liege,Grejohn Kyei,fr FRA,FW,28.0,2.4,2,1,1,0,1,2,3,66.7,1,0,0,0,0,2,6,0
Standard Liege,Alexandro Calut,be BEL,DF,21.0,2.2,3,1,1,2,0,1,7,14.3,6,1,0,1,5,8,6,0
Standard Liege,Arnaud Bodart,be BEL,GK,26.0,2.0,0,0,0,0,0,0,0,,0,0,0,0,0,0,5,0
Standard Liege,Souleyman Doumbia,ci CIV,DF,27.0,2.1,9,5,7,2,0,5,7,71.4,2,2,0,2,3,12,18,1
Standard Liege,Lucas Noubi,be BEL,DF,19.0,1.5,2,0,0,2,0,1,2,50.0,1,1,0,1,4,6,7,0
Standard Liege,Muhammed Badamosi,gm GAM,FW,25.0,1.3,3,1,2,1,0,0,0,,0,2,0,2,0,3,2,0
Standard Liege,Viktor Đukanović,me MNE,DF,20.0,0.5,0,0,0,0,0,0,0,,0,0,0,0,0,0,0,0
Standard Liege,Sacha Banse,bf BFA,MF,23.0,0.4,2,1,1,1,0,0,0,,0,1,0,1,0,2,3,0
Standard Liege,Kilian Lokembo,be BEL,DF,22.0,0.0,1,0,1,0,0,0,1,0.0,1,0,0,0,0,1,0,0
Mechelen,Ortwin De Wolf,be BEL,GK,27.0,30.0,0,0,0,0,0,0,1,0.0,1,0,0,0,1,1,11,3
Mechelen,Rob Schoofs,be BEL,MF,30.0,27.5,55,23,18,27,10,27,43,62.8,16,30,6,24,24,79,29,0
Mechelen,José Marsà,es ESP,DF,22.0,25.3,42,31,22,17,3,18,27,66.7,9,42,19,23,22,64,96,2
Mechelen,Toon Raemaekers,be BEL,DF,23.0,24.8,63,37,46,15,2,39,66,59.1,27,37,14,23,34,97,106,0
Mechelen,Kerim Mrabti,se SWE,MF,30.0,22.5,32,17,9,17,6,12,28,42.9,16,27,10,17,14,46,26,1
Mechelen,Ahmed Touba,dz ALG,DF,26.0,22.2,39,25,26,10,3,17,31,54.8,14,15,11,4,33,72,104,2
Mechelen,Aziz Ouattara,ci CIV,MF,23.0,17.4,39,28,20,14,5,14,32,43.8,18,24,9,15,20,59,44,0
Mechelen,Daam Foulon,be BEL,DF,25.0,17.7,44,22,26,13,5,26,47,55.3,21,13,3,10,11,55,42,0
Mechelen,Patrick Pflücke,de GER,DF,27.0,16.4,29,20,23,5,1,22,46,47.8,24,18,2,16,3,32,31,0
Mechelen,Nikola Storm,be BEL,MF,29.0,15.7,12,8,2,9,1,6,13,46.2,7,9,1,8,8,20,11,1
Mechelen,Rafik Belghali,dz ALG,DF,22.0,17.4,33,25,24,9,0,21,26,80.8,5,19,1,18,16,49,40,1
Mechelen,Lion Lauberbach,de GER,FW,26.0,15.4,8,5,2,5,1,2,7,28.6,5,7,0,7,1,9,15,0
Mechelen,Benito Raman,be BEL,FW,29.0,12.8,14,7,6,2,6,2,18,11.1,16,4,0,4,1,15,3,0
Mechelen,Geoffry Hairemans,be BEL,MF,32.0,13.3,22,14,5,14,3,12,36,33.3,24,14,1,13,11,33,20,0
Mechelen,Fredrik Hammer,se SWE,MF,23.0,8.8,24,16,8,13,3,12,23,52.2,11,16,4,12,18,42,31,2
Mechelen,Bas van den Eynden,be BEL,DF,22.0,8.1,12,7,10,2,0,5,8,62.5,3,17,10,7,10,22,50,0
Mechelen,Bilal Bafdili,be BEL,MF,19.0,9.8,16,10,5,8,3,6,9,66.7,3,7,1,6,2,18,2,0
Mechelen,Stephen Welsh,sct SCO,DF,24.0,4.5,5,2,3,2,0,3,7,42.9,4,5,4,1,3,8,23,1
Mechelen,Jules Van Cleemput,be BEL,DF,27.0,3.5,4,3,2,2,0,2,7,28.6,5,5,4,1,10,14,9,0
Mechelen,Petter Nosa Dahl,no NOR,MF,21.0,5.1,11,7,3,3,5,6,11,54.5,5,7,2,5,6,17,2,0
Mechelen,Bill Antonio,zw ZIM,DF,21.0,3.9,7,2,2,1,4,1,3,33.3,2,4,0,4,3,10,4,0
Mechelen,Sandy Walsh,id IDN,DF,29.0,2.2,1,1,1,0,0,1,1,100.0,0,3,2,1,2,3,9,0
Mechelen,Zinho Vanheusden,be BEL,DF,25.0,1.8,1,0,1,0,0,0,0,,0,2,2,0,3,4,11,0
Mechelen,Keano Vanrafelghem,be BEL,MF,20.0,1.8,1,1,0,1,0,0,2,0.0,2,0,0,0,0,1,1,0
Mechelen,Mory Konaté,gn GUI,DF,30.0,1.4,3,3,3,0,0,1,2,50.0,1,2,1,1,0,3,10,0
Mechelen,Julien Ngoy,be BEL,FW,26.0,1.3,0,0,0,0,0,0,0,,0,0,0,0,0,0,2,0
Mechelen,Elton Yeboah,be BEL,MF,19.0,0.1,0,0,0,0,0,0,0,,0,0,0,0,0,0,1,0
Westerlo,Dogucan Haspolat,tr TUR,MF,24.0,29.0,86,48,30,48,8,33,66,50.0,33,47,12,35,50,136,65,0
Westerlo,Luka Vušković,hr CRO,DF,17.0,27.5,23,16,18,5,0,11,23,47.8,12,40,31,9,26,49,181,0
Westerlo,Tuur Rommens,be BEL,DF,21.0,26.6,54,32,30,18,6,23,44,52.3,21,42,15,27,46,100,103,2
Westerlo,Bryan Reynolds,us USA,DF,23.0,26.3,46,32,26,12,8,22,39,56.4,17,29,10,19,20,66,54,1
Westerlo,Allahyar Sayyadmanesh,ir IRN,FW,23.0,20.2,35,24,10,15,10,17,30,56.7,13,19,4,15,4,39,31,0
Westerlo,Matija Frigan,hr CRO,FW,21.0,20.6,12,6,2,7,3,5,16,31.3,11,7,1,6,2,14,12,0
Westerlo,Alfie Devine,eng ENG,MF,19.0,17.9,23,14,5,14,4,14,20,70.0,6,12,0,12,15,38,13,0
Westerlo,Arthur Piedfort,be BEL,MF,19.0,15.6,37,19,8,20,9,13,24,54.2,11,15,3,12,13,50,20,0
Westerlo,Griffin Yow,us USA,FW,21.0,17.1,51,35,29,16,6,20,40,50.0,20,16,0,16,6,57,27,1
Westerlo,Emin Bayram,tr TUR,DF,21.0,16.7,28,17,16,12,0,12,23,52.2,11,25,13,12,32,60,100,1
Westerlo,Roman Neustädter,ru RUS,DF,36.0,16.0,24,11,16,8,0,13,21,61.9,8,14,7,7,25,49,89,0
Westerlo,Josimar Alcocer,cr CRC,FW,20.0,14.6,48,38,29,15,4,24,46,52.2,22,13,2,11,18,66,42,0
Westerlo,Jordan Bos,au AUS,DF,21.0,11.5,22,15,7,9,6,7,16,43.8,9,22,4,18,14,36,25,0
Westerlo,Sinan Bolat,tr TUR,GK,35.0,11.0,1,0,1,0,0,1,1,100.0,0,0,0,0,0,1,2,2
Westerlo,Koen Van Langendonck,be BEL,GK,35.0,10.0,0,0,0,0,0,0,0,,0,0,0,0,0,0,4,1
Westerlo,Andreas Jungdal,dk DEN,GK,22.0,8.0,0,0,0,0,0,0,1,0.0,1,1,0,1,0,0,9,1
Westerlo,Isa Sakamoto,jp JPN,MF,20.0,7.4,12,7,5,5,2,5,21,23.8,16,6,0,6,4,16,0,0
Westerlo,Thomas Van den Keybus,be BEL,MF,23.0,7.7,23,12,11,10,2,11,23,47.8,12,14,6,8,4,27,18,0
Westerlo,Dire Mebude,sct SCO,FW,20.0,7.6,5,4,2,2,1,3,10,30.0,7,7,0,7,4,9,5,0
Westerlo,Lucas Stassin,be BEL,FW,19.0,4.5,4,3,1,0,3,1,3,33.3,2,0,0,0,1,5,2,0
Westerlo,Nicolas Madsen,dk DEN,MF,24.0,4.0,10,7,4,5,1,5,8,62.5,3,3,1,2,3,13,8,0
Westerlo,Serhiy Sydorchuk,ua UKR,MF,33.0,3.6,7,5,2,4,1,2,5,40.0,3,3,0,3,3,10,4,0
Westerlo,Islam Slimani,dz ALG,FW,36.0,2.5,2,1,2,0,0,1,3,33.3,2,0,0,0,0,2,3,0
Westerlo,Emir Ortakaya,tr TUR,DF,20.0,1.7,4,0,2,1,1,1,1,100.0,0,2,1,1,4,8,9,0
Westerlo,Nick Gillekens,be BEL,GK,29.0,1.0,0,0,0,0,0,0,0,,0,0,0,0,0,0,1,1
Westerlo,Edisson Jordanov,bg BUL,DF,31.0,0.8,1,1,1,0,0,1,2,50.0,1,1,0,1,2,3,2,0
Westerlo,Rhys Youlley,au AUS,FW,19.0,0.5,5,3,2,1,2,2,3,66.7,1,1,0,1,0,5,2,0
Westerlo,Muhammed Gümüskaya,tr TUR,FW,23.0,0.3,0,0,0,0,0,0,1,0.0,1,0,0,0,1,1,0,0
Westerlo,Amando Lapage,be BEL,DF,19.0,0.3,1,0,1,0,0,1,1,100.0,0,0,0,0,0,1,2,0
Westerlo,Mathias Fixelles,be BEL,FW,27.0,0.2,3,1,0,3,0,2,2,100.0,0,0,0,0,0,3,1,0
Charleroi,Adem Zorgane,dz ALG,MF,24.0,29.9,80,54,32,39,9,35,89,39.3,54,43,11,32,30,110,39,2
Charleroi,Daan Heymans,be BEL,MF,25.0,28.0,46,29,9,32,5,13,26,50.0,13,23,3,20,14,60,45,1
Charleroi,Jérémy Pétris,fr FRA,DF,26.0,25.5,56,36,31,22,3,23,30,76.7,7,13,2,11,32,88,60,0
Charleroi,Vetle Dragsnes,no NOR,DF,30.0,24.0,42,31,28,11,3,26,53,49.1,27,26,6,20,9,51,95,0
Charleroi,Parfait Guiagon,ci CIV,FW,23.0,22.2,24,18,5,13,6,8,23,34.8,15,15,0,15,8,32,11,0
Charleroi,Stelios Andreou,cy CYP,DF,22.0,24.2,38,22,31,6,1,18,26,69.2,8,34,25,9,31,69,109,2
Charleroi,Aiham Ousou,sy SYR,DF,24.0,22.5,34,22,25,8,1,15,24,62.5,9,25,18,7,40,74,128,0
Charleroi,Mohamed Koné,ci CIV,GK,22.0,21.0,1,1,1,0,0,1,2,50.0,1,1,0,1,0,1,17,3
Charleroi,Antoine Bernier,be BEL,FW,26.0,18.7,40,28,5,23,12,18,32,56.3,14,21,0,21,7,47,7,0
Charleroi,Yassine Titraoui,dz ALG,MF,21.0,16.6,41,29,24,13,4,19,48,39.6,29,21,6,15,24,65,22,0
Charleroi,Nikola Štulić,rs SRB,FW,22.0,16.1,17,8,4,7,6,7,10,70.0,3,9,1,8,6,23,13,0
Charleroi,Check Keita,fr FRA,DF,21.0,13.2,23,16,17,6,0,12,15,80.0,3,18,7,11,7,30,44,1
Charleroi,Etienne Camara,fr FRA,MF,21.0,12.0,27,13,10,16,1,11,22,50.0,11,12,2,10,11,38,12,0
Charleroi,Isaac Mbenza,be BEL,FW,28.0,10.4,11,10,4,5,2,7,19,36.8,12,5,1,4,3,14,16,0
Charleroi,Žan Rogelj,si SVN,DF,24.0,9.2,16,9,8,6,2,9,17,52.9,8,8,4,4,9,25,39,0
Charleroi,Martin Delavallée,be BEL,GK,20.0,8.0,0,0,0,0,0,0,1,0.0,1,0,0,0,0,0,7,1
Charleroi,Mardochee Nzita,be BEL,DF,24.0,6.3,13,8,9,3,1,7,15,46.7,8,7,1,6,3,16,21,0
Charleroi,Grejohn Kyei,fr FRA,FW,28.0,4.2,3,1,0,3,0,2,3,66.7,1,2,1,1,0,3,4,0
Charleroi,Oday Dabbagh,ps PLE,FW,25.0,5.5,2,2,0,1,1,0,3,0.0,3,3,0,3,0,2,1,0
Charleroi,Youssuf Sylla,be BEL,FW,21.0,4.4,2,0,0,2,0,0,1,0.0,1,1,0,1,1,3,5,0
Charleroi,Alexis Flips,fr FRA,FW,24.0,3.1,8,2,7,1,0,5,11,45.5,6,2,0,2,2,10,4,0
Charleroi,Youssouph Badji,sn SEN,FW,22.0,2.3,2,1,1,0,1,1,2,50.0,1,3,0,3,0,2,3,0
Charleroi,Massamba Sow,fr FRA,DF,20.0,1.5,3,2,2,1,0,2,4,50.0,2,3,3,0,2,5,5,0
Charleroi,Théo Defourny,be BEL,GK,32.0,1.0,0,0,0,0,0,0,0,,0,0,0,0,0,0,0,0
Charleroi,Raymond Asante,gh GHA,FW,20.0,0.7,1,0,0,1,0,1,1,100.0,0,0,0,0,0,1,1,0
Charleroi,Alexandre Stanic,be BEL,FW,19.0,0.1,0,0,0,0,0,0,0,,0,0,0,0,0,0,0,0
Charleroi,Quentin Benaets,be BEL,DF,20.0,0.1,1,1,1,0,0,1,1,100.0,0,0,0,0,0,1,0,0
Charleroi,Amine Boukamir,ma MAR,MF,17.0,0.1,0,0,0,0,0,0,0,,0,0,0,0,0,0,0,0
Charleroi,Noam Mayoka-Tika,be BEL,MF,20.0,0.1,0,0,0,0,0,0,0,,0,0,0,0,0,0,1,0
OH Leuven,Tobe Leysen,be BEL,GK,22.0,29.0,0,0,0,0,0,0,0,,0,0,0,0,1,1,17,1
OH Leuven,Birger Verstraete,be BEL,MF,30.0,23.9,54,31,30,18,6,18,43,41.9,25,24,5,19,43,97,52,0
OH Leuven,Ezechiel Banzuzi,nl NED,MF,19.0,23.2,70,40,28,35,7,25,42,59.5,17,26,10,16,13,83,43,0
OH Leuven,Takahiro Akimoto,jp JPN,DF,26.0,22.6,64,36,43,19,2,39,59,66.1,20,27,7,20,24,88,102,0
OH Leuven,Federico Ricca,uy URU,DF,29.0,21.2,30,20,22,7,1,13,23,56.5,10,33,20,13,22,52,138,0
OH Leuven,Siebe Schrijvers,be BEL,MF,28.0,20.3,63,33,18,36,9,28,44,63.6,16,27,6,21,33,96,55,0
OH Leuven,Konan N'dri,ci CIV,FW,23.0,17.8,38,21,13,16,9,11,26,42.3,15,24,2,22,6,44,10,0
OH Leuven,Hasan Kuruçay,,DF,26.0,17.3,22,14,15,7,0,14,23,60.9,9,11,9,2,15,37,86,1
OH Leuven,Youssef Maziz,fr FRA,MF,26.0,15.9,7,3,4,3,0,3,6,50.0,3,6,0,6,13,20,12,0
OH Leuven,Chukwubuikem Ikwuemesi,ng NGA,FW,22.0,17.1,11,10,1,5,5,1,5,20.0,4,10,2,8,4,15,14,0
OH Leuven,Thibault Vlietinck,be BEL,DF,26.0,14.2,17,11,9,6,2,14,31,45.2,17,17,5,12,6,23,32,0
OH Leuven,Stefan Mitrović,rs SRB,FW,21.0,14.1,19,13,8,7,4,10,19,52.6,9,9,1,8,10,29,10,0
OH Leuven,Takuma Ominami,jp JPN,DF,26.0,14.8,20,13,17,3,0,10,14,71.4,4,15,7,8,6,26,57,0
OH Leuven,William Balikwisha,cd COD,FW,25.0,12.1,19,11,6,8,5,5,8,62.5,3,14,0,14,11,30,9,0
OH Leuven,Óscar Gil,es ESP,DF,27.0,11.2,30,19,17,11,2,12,30,40.0,18,21,5,16,14,44,31,0
OH Leuven,Mathieu Maertens,be BEL,FW,29.0,8.7,6,5,2,2,2,1,7,14.3,6,10,1,9,5,11,6,0
OH Leuven,Ewoud Pletinckx,be BEL,DF,23.0,9.3,7,3,4,3,0,3,4,75.0,1,18,13,5,6,13,54,0
OH Leuven,Manuel Osifo,be BEL,DF,21.0,8.1,21,14,10,10,1,16,25,64.0,9,12,1,11,10,31,26,0
OH Leuven,Hamza Mendyl,ma MAR,DF,26.0,6.5,16,12,8,7,1,7,10,70.0,3,11,2,9,4,20,21,0
OH Leuven,Lequincio Zeefuik,nl NED,FW,19.0,5.3,5,4,0,2,3,2,6,33.3,4,4,1,3,0,5,8,0
OH Leuven,Thibaud Verlinden,be BEL,FW,25.0,4.0,2,2,1,1,0,1,8,12.5,7,8,1,7,1,3,3,0
OH Leuven,Joël Schingtienne,be BEL,DF,21.0,4.0,10,5,7,3,0,6,6,100.0,0,9,4,5,4,14,14,0
OH Leuven,Wouter George,be BEL,MF,22.0,1.9,9,2,3,6,0,4,14,28.6,10,6,1,5,0,9,2,0
OH Leuven,Jovan Mijatović,rs SRB,FW,19.0,1.5,1,1,0,1,0,1,4,25.0,3,0,0,0,0,1,1,0
OH Leuven,Maxence Prevot,fr FRA,GK,27.0,1.0,0,0,0,0,0,0,0,,0,0,0,0,0,0,0,0
OH Leuven,Suphanat Mueanta,th THA,FW,21.0,0.7,1,1,0,1,0,0,0,,0,0,0,0,0,1,1,0
OH Leuven,Mickaël Biron,mq MTQ,FW,26.0,1.4,4,3,1,3,0,0,2,0.0,2,1,0,1,0,4,1,0
OH Leuven,Jón Dagur Þorsteinsson,is ISL,MF,25.0,1.0,1,1,0,0,1,0,1,0.0,1,0,0,0,1,2,1,0
OH Leuven,Ayumu Ohata,jp JPN,DF,23.0,0.6,0,0,0,0,0,0,1,0.0,1,1,0,1,1,1,0,0
OH Leuven,Antef Tsoungui,be BEL,DF,21.0,0.5,1,1,0,1,0,0,1,0.0,1,1,0,1,1,2,2,0
OH Leuven,Davis Opoku,be BEL,"FW,DF",16.0,0.0,0,0,0,0,0,0,0,,0,0,0,0,0,0,0,0
Dender,Nathan Rôdes,be BEL,MF,26.0,29.3,69,39,34,25,10,34,76,44.7,42,64,15,49,30,99,72,1
Dender,Kobe Cools,be BEL,DF,27.0,29.3,35,18,22,10,3,11,21,52.4,10,60,50,10,59,94,230,1
Dender,Fabio Ferraro,be BEL,DF,21.0,26.8,69,47,41,18,10,40,62,64.5,22,41,5,36,29,98,95,1
Dender,Gilles Ruyssen,be BEL,DF,30.0,27.6,47,33,32,11,4,25,46,54.3,21,32,19,13,50,97,170,1
Dender,Michael Verrips,nl NED,GK,27.0,26.0,0,0,0,0,0,0,2,0.0,2,0,0,0,1,1,7,2
Dender,Joedrick Pupe,be BEL,DF,27.0,24.1,35,23,19,15,1,21,37,56.8,16,36,14,22,36,71,116,0
Dender,Roman Květ,cz CZE,MF,26.0,21.3,39,20,14,14,11,21,52,40.4,31,28,2,26,15,54,22,0
Dender,Bruny Nsimba,be BEL,FW,24.0,21.6,23,14,6,10,7,6,16,37.5,10,6,0,6,2,25,16,1
Dender,Aurélien Scheidler,fr FRA,FW,26.0,16.7,11,7,4,6,1,4,9,44.4,5,8,0,8,2,13,17,0
Dender,David Hrnčár,sk SVK,DF,26.0,17.8,25,15,16,8,1,17,29,58.6,12,16,4,12,22,47,58,0
Dender,Mohamed Berte,be BEL,FW,22.0,14.9,20,12,7,10,3,6,20,30.0,14,7,0,7,3,23,5,0
Dender,Bryan Goncalves,fr FRA,DF,28.0,11.5,30,18,16,12,2,21,30,70.0,9,18,9,9,17,47,74,1
Dender,Malcolm Viltard,fr FRA,MF,21.0,12.1,31,13,14,13,4,12,30,40.0,18,28,3,25,20,51,34,1
Dender,Ragnar Oratmangoen,id IDN,MF,26.0,11.3,23,17,7,11,5,14,24,58.3,10,10,1,9,8,31,19,0
Dender,Lennard Hens,be BEL,MF,28.0,8.4,21,13,2,14,5,10,29,34.5,19,16,3,13,12,33,10,0
Dender,Dembo Sylla,gn GUI,DF,21.0,7.5,19,12,13,6,0,6,11,54.5,5,6,1,5,6,25,20,1
Dender,Karol Fila,pl POL,DF,26.0,4.1,15,7,8,6,1,6,13,46.2,7,3,0,3,6,21,12,0
Dender,Jordy Soladio,be BEL,FW,26.0,4.6,1,1,0,1,0,0,1,0.0,1,4,1,3,0,1,7,0
Dender,Julien Devriendt,be BEL,GK,25.0,3.5,1,0,1,0,0,1,1,100.0,0,0,0,0,0,1,2,0
Dender,Noah Mbamba,be BEL,MF,19.0,2.2,9,3,2,5,2,2,5,40.0,3,1,0,1,1,10,5,0
Dender,Jasper Van Oudenhove,be BEL,MF,25.0,1.7,4,2,2,1,1,2,6,33.3,4,0,0,0,1,5,4,0
Dender,Tom Holmes,eng ENG,DF,24.0,1.1,2,2,0,2,0,1,3,33.3,2,0,0,0,1,3,6,0
Dender,Desmond Acquah,be BEL,MF,22.0,2.6,7,7,1,4,2,3,14,21.4,11,8,1,7,3,10,3,0
Dender,Ridwane M'Barki,be BEL,DF,30.0,1.6,3,2,2,0,1,3,7,42.9,4,7,1,6,2,5,4,0
Dender,Guillaume Dietsch,fr FRA,GK,23.0,0.5,0,0,0,0,0,0,0,,0,0,0,0,0,0,0,0
Dender,Ali Akman,tr TUR,FW,22.0,0.5,3,2,0,1,2,2,3,66.7,1,0,0,0,0,3,0,0
Dender,Kéres Masangu,be BEL,DF,24.0,0.1,0,0,0,0,0,0,0,,0,1,0,1,0,0,1,0
Cercle Brugge,Thibo Somers,be BEL,FW,25.0,28.6,41,26,16,15,10,17,47,36.2,30,49,5,44,15,56,38,0
Cercle Brugge,Christiaan Ravych,be BEL,DF,22.0,26.7,62,38,33,28,1,35,56,62.5,21,39,27,12,34,96,131,1
Cercle Brugge,Hannes Van der Bruggen,be BEL,MF,31.0,22.4,52,42,18,25,9,28,69,40.6,41,32,7,25,35,87,50,0
Cercle Brugge,Lawrence Agyekum,gh GHA,MF,20.0,21.9,71,42,25,33,13,35,67,52.2,32,58,3,55,30,101,28,0
Cercle Brugge,Gary Magnée,be BEL,DF,24.0,19.4,38,27,19,14,5,25,48,52.1,23,39,5,34,25,63,64,0
Cercle Brugge,Erick Nunes,br BRA,MF,20.0,17.3,54,31,17,23,14,29,62,46.8,33,47,6,41,20,74,39,1
Cercle Brugge,Maxime Delanghe,be BEL,GK,23.0,20.9,0,0,0,0,0,0,0,,0,1,0,1,0,0,21,0
Cercle Brugge,Ibrahim Diakité,gn GUI,DF,20.0,18.3,27,19,15,10,2,16,25,64.0,9,37,9,28,21,48,80,1
Cercle Brugge,Francis Abu,gh GHA,MF,23.0,18.5,74,48,17,42,15,34,54,63.0,20,16,2,14,21,95,46,0
Cercle Brugge,Felipe Augusto,br BRA,FW,20.0,15.5,10,9,3,4,3,3,7,42.9,4,19,4,15,4,14,13,0
Cercle Brugge,Alan Minda,ec ECU,FW,21.0,14.6,8,5,3,2,3,6,13,46.2,7,11,1,10,2,10,4,0
Cercle Brugge,Kévin Denkey,tg TOG,FW,23.0,14.6,6,5,1,3,2,3,3,100.0,0,7,0,7,0,6,3,0
Cercle Brugge,Emmanuel Kakou,ci CIV,DF,19.0,14.1,28,15,19,8,1,15,34,44.1,19,23,10,13,26,54,69,0
Cercle Brugge,Flávio Nazinho,pt POR,DF,21.0,13.1,36,22,18,13,5,22,32,68.8,10,23,3,20,22,58,41,2
Cercle Brugge,Edgaras Utkus,lt LTU,DF,24.0,10.9,25,17,17,7,1,15,21,71.4,6,15,5,10,17,42,82,1
Cercle Brugge,Kazeem Olaigbe,be BEL,MF,21.0,10.1,17,13,4,8,5,10,18,55.6,8,12,0,12,1,18,4,0
Cercle Brugge,Warleson,br BRA,GK,27.0,9.1,1,0,1,0,0,1,3,33.3,2,0,0,0,0,1,14,2
Cercle Brugge,Senna Miangue,be BEL,DF,27.0,8.9,7,6,3,4,0,7,14,50.0,7,9,3,6,12,19,55,0
Cercle Brugge,Lucas Perrin,fr FRA,DF,25.0,5.5,17,12,10,5,2,12,15,80.0,3,5,2,3,11,28,21,0
Cercle Brugge,Bruninho,br BRA,MF,21.0,4.7,8,5,3,2,3,2,7,28.6,5,5,0,5,1,9,2,0
Cercle Brugge,Paris Brunner,de GER,FW,18.0,3.8,7,1,1,2,4,2,4,50.0,2,2,0,2,0,7,2,0
Cercle Brugge,Kader Ouattara,bf BFA,MF,19.0,3.2,6,4,0,2,4,1,3,33.3,2,10,2,8,1,7,0,0
Cercle Brugge,Malamine Efekele,fr FRA,MF,20.0,2.7,4,2,1,2,1,2,3,66.7,1,2,1,1,3,7,4,0
Cercle Brugge,Jesper Daland,no NOR,DF,24.0,2.0,3,2,2,1,0,1,1,100.0,0,3,2,1,2,5,10,0
Cercle Brugge,Boris Popović,rs SRB,DF,24.0,1.8,1,1,0,1,0,0,1,0.0,1,4,2,2,3,4,2,0
Cercle Brugge,Nils De Wilde,be BEL,MF,21.0,1.3,2,1,1,1,0,1,5,20.0,4,3,0,3,0,2,4,0
Cercle Brugge,Jonas Lietaert,be BEL,DF,20.0,0.6,4,3,1,3,0,3,7,42.9,4,1,0,1,1,5,3,0
Cercle Brugge,Steve Ngoura,fr FRA,FW,19.0,0.3,1,1,0,0,1,1,1,100.0,0,0,0,0,0,1,1,0
Cercle Brugge,Heriberto Jurado,mx MEX,MF,19.0,0.0,0,0,0,0,0,0,0,,0,0,0,0,0,0,0,0
Sint Truiden,Bruno Godeau,be BEL,DF,32.0,27.4,41,31,30,10,1,27,44,61.4,17,38,22,16,38,79,160,2
Sint Truiden,Ryoya Ogawa,jp JPN,DF,27.0,27.3,50,28,32,11,7,31,59,52.5,28,45,9,36,30,80,96,1
Sint Truiden,Leo Kokubo,jp JPN,GK,23.0,27.0,1,0,1,0,0,1,2,50.0,1,0,0,0,0,1,17,2
Sint Truiden,Joel Fujita,jp JPN,MF,22.0,26.7,66,41,34,28,4,26,65,40.0,39,34,13,21,42,108,53,1
Sint Truiden,Rein Van Helden,be BEL,DF,22.0,26.0,63,37,47,13,3,33,51,64.7,18,45,27,18,30,93,156,0
Sint Truiden,Adriano Bertaccini,be BEL,FW,23.0,24.8,18,10,9,5,4,6,26,23.1,20,15,2,13,4,22,19,0
Sint Truiden,Ryotaro Ito,jp JPN,MF,26.0,22.5,29,19,14,11,4,16,40,40.0,24,8,1,7,13,42,14,0
Sint Truiden,Louis Patris,be BEL,DF,23.0,18.7,76,36,31,30,15,37,74,50.0,37,32,8,24,26,102,52,1
Sint Truiden,Bilal Brahimi,dz ALG,MF,24.0,16.6,9,6,4,3,2,5,19,26.3,14,7,0,7,9,18,11,1
Sint Truiden,Robert-Jan Vanwesemael,be BEL,MF,22.0,15.7,31,21,14,8,9,16,32,50.0,16,24,9,15,17,48,32,0
Sint Truiden,Kahveh Zahiroleslam,us USA,FW,22.0,12.0,9,7,0,8,1,2,10,20.0,8,9,1,8,2,11,14,0
Sint Truiden,Shogo Taniguchi,jp JPN,DF,33.0,10.5,12,10,5,7,0,5,11,45.5,6,11,8,3,14,26,54,1
Sint Truiden,Rihito Yamamoto,jp JPN,MF,22.0,10.6,21,13,8,11,2,9,23,39.1,14,19,5,14,9,30,24,1
Sint Truiden,Zineddine Belaid,dz ALG,DF,25.0,10.2,12,7,10,2,0,4,7,57.1,3,17,12,5,13,25,56,3
Sint Truiden,Wolke Janssens,be BEL,DF,29.0,9.8,40,20,25,14,1,18,37,48.6,19,17,9,8,16,56,60,0
Sint Truiden,Andrés Ferrari,uy URU,FW,21.0,9.2,14,9,5,5,4,6,12,50.0,6,8,0,8,2,16,6,0
Sint Truiden,Didier Lamkel Zé,cm CMR,FW,27.0,7.2,4,2,1,1,2,3,3,100.0,0,3,0,3,0,4,6,0
Sint Truiden,Loïc Lapoussin,mg MAD,MF,28.0,5.7,19,13,8,9,2,11,25,44.0,14,9,1,8,13,32,6,0
Sint Truiden,Olivier Dumont,be BEL,MF,22.0,4.9,15,10,10,4,1,7,12,58.3,5,1,0,1,1,16,9,0
Sint Truiden,Jo Coppens,be BEL,GK,33.0,3.0,0,0,0,0,0,0,0,,0,0,0,0,0,0,1,0
Sint Truiden,Frederic Ananou,tg TOG,DF,26.0,2.2,9,6,7,2,0,7,9,77.8,2,0,0,0,2,11,9,0
Sint Truiden,Visar Musliu,mk MKD,DF,29.0,2.1,5,3,5,0,0,2,4,50.0,2,2,2,0,8,13,16,1
Sint Truiden,Alouis Diriken,be BEL,MF,20.0,1.6,2,0,1,1,0,1,3,33.3,2,0,0,0,2,4,1,0
Sint Truiden,Adam Nhaili,be BEL,FW,18.0,2.3,2,1,2,0,0,0,1,0.0,1,1,0,1,1,3,1,0
Sint Truiden,Isaías Delpupo,ar ARG,"FW,DF",21.0,1.5,4,2,1,3,0,4,5,80.0,1,3,0,3,0,4,3,0
Sint Truiden,Simen Juklerød,no NOR,DF,30.0,1.1,1,1,0,1,0,0,2,0.0,2,1,1,0,2,3,5,0
Sint Truiden,David Mindombe,be BEL,DF,23.0,1.0,0,0,0,0,0,0,0,,0,0,0,0,1,1,10,0
Sint Truiden,Joselpho Barnes,gh GHA,FW,22.0,1.3,2,0,0,2,0,0,0,,0,2,0,2,0,2,2,0
Sint Truiden,Hugo Lambotte,be BEL,MF,18.0,0.4,0,0,0,0,0,0,2,0.0,2,3,0,3,0,0,0,0
Sint Truiden,Jay-David Mbalanda,fr FRA,FW,17.0,0.2,1,1,0,1,0,0,1,0.0,1,0,0,0,0,1,0,0
Sint Truiden,Hiiro komori,jp JPN,MF,23.0,0.2,0,0,0,0,0,0,1,0.0,1,0,0,0,0,0,0,0
Sint Truiden,Arthur Alexis,be BEL,MF,18.0,0.1,0,0,0,0,0,0,0,,0,0,0,0,0,0,0,0
Kortrijk,Nayel Mehssatou,cl CHI,MF,22.0,25.3,57,32,21,29,7,28,46,60.9,18,35,4,31,16,73,40,1
Kortrijk,João Silva,pt POR,DF,25.0,20.8,29,20,21,7,1,16,22,72.7,6,42,28,14,33,62,99,2
Kortrijk,Nacho Ferri,es ESP,FW,19.0,20.6,19,13,3,8,8,3,12,25.0,9,19,2,17,2,21,25,0
Kortrijk,Dion De Neve,be BEL,DF,22.0,20.5,44,27,24,11,9,19,38,50.0,19,34,4,30,11,55,48,1
Kortrijk,Abdelkahar Kadri,dz ALG,MF,24.0,18.6,34,19,12,15,7,15,26,57.7,11,28,3,25,12,46,12,2
Kortrijk,Bram Lagae,be BEL,DF,20.0,18.5,24,15,17,7,0,16,27,59.3,11,32,16,16,21,45,111,2
Kortrijk,Thierry Ambrose,gp GLP,FW,27.0,19.2,15,7,3,10,2,3,17,17.6,14,15,2,13,2,17,17,0
Kortrijk,Abdoulaye Sissako,fr FRA,MF,26.0,17.6,46,23,20,18,8,23,45,51.1,22,23,7,16,22,68,47,0
Kortrijk,Haruya Fujii,jp JPN,DF,23.0,17.2,21,13,14,6,1,9,17,52.9,8,22,11,11,21,42,83,0
Kortrijk,Brecht Dejaegere,be BEL,MF,33.0,15.2,46,28,16,18,12,23,47,48.9,24,33,8,25,26,72,17,0
Kortrijk,Gilles Dewaele,be BEL,DF,28.0,12.2,14,9,6,6,2,7,17,41.2,10,7,1,6,12,26,34,1
Kortrijk,Mark Mampasi,ua UKR,DF,21.0,11.6,20,12,11,7,2,9,17,52.9,8,13,5,8,12,32,71,0
Kortrijk,Tomoki Takamine,jp JPN,MF,26.0,11.0,20,10,8,10,2,5,15,33.3,10,9,0,9,6,26,24,0
Kortrijk,Patrik Gunnarsson,is ISL,GK,23.0,10.3,0,0,0,0,0,0,0,,0,1,0,1,0,0,4,1
Kortrijk,Takuro Kaneko,jp JPN,MF,27.0,10.0,20,15,9,6,5,10,19,52.6,9,14,1,13,7,27,8,0
Kortrijk,Tom Vandenberghe,be BEL,GK,31.0,9.0,0,0,0,0,0,0,0,,0,0,0,0,0,0,5,0
Kortrijk,Dermane Karim,tg TOG,MF,20.0,7.7,25,13,12,11,2,11,17,64.7,6,4,0,4,3,28,7,0
Kortrijk,Marco Ilaimaharitra,mg MAD,MF,29.0,7.0,11,9,3,4,4,6,17,35.3,11,11,0,11,4,15,9,0
Kortrijk,Jean-Kevin Duverne,ht HAI,DF,27.0,7.0,19,11,10,7,2,12,27,44.4,15,6,1,5,7,26,28,0
Kortrijk,Ryan Alebiosu,eng ENG,DF,22.0,6.8,15,5,8,5,2,8,10,80.0,2,4,0,4,7,22,16,0
Kortrijk,Billal Messaoudi,dz ALG,FW,26.0,7.0,7,4,4,3,0,3,7,42.9,4,9,1,8,1,8,6,0
Kortrijk,Massimo Bruno,be BEL,MF,30.0,6.5,16,8,9,5,2,7,15,46.7,8,9,1,8,1,17,9,0
Kortrijk,Lucas Pirard,be BEL,GK,29.0,6.0,0,0,0,0,0,0,1,0.0,1,0,0,0,1,1,5,1
Kortrijk,Ryotaro Tsunoda,jp JPN,DF,25.0,5.1,12,9,8,3,1,3,8,37.5,5,7,3,4,12,24,47,0
Kortrijk,Marko Ilić,rs SRB,GK,26.0,4.7,0,0,0,0,0,0,0,,0,0,0,0,0,0,2,1
Kortrijk,Mounaim El Idrissy,fr FRA,DF,25.0,3.9,7,7,6,1,0,1,4,25.0,3,3,1,2,4,11,6,0
Kortrijk,Koen Kostons,nl NED,FW,24.0,2.9,4,3,1,1,2,3,4,75.0,1,4,1,3,0,4,4,0
Kortrijk,Iver Fossum,no NOR,MF,28.0,2.6,10,5,3,5,2,7,12,58.3,5,6,1,5,1,11,2,0
Kortrijk,James Ndjeungoue,cm CMR,DF,21.0,2.5,7,3,7,0,0,7,11,63.6,4,4,0,4,8,15,15,0
Kortrijk,Roko Simic,hr CRO,FW,20.0,1.6,0,0,0,0,0,0,3,0.0,3,2,0,2,0,0,3,0
Kortrijk,Mouhamed Guèye,sn SEN,DF,20.0,1.3,2,1,0,1,1,0,2,0.0,2,1,1,0,0,2,19,0
Kortrijk,Karol Czubak,pl POL,FW,24.0,0.7,0,0,0,0,0,0,0,,0,0,0,0,0,0,1,0
Kortrijk,Kyan Himpe,be BEL,"FW,DF",18.0,0.0,0,0,0,0,0,0,0,,0,0,0,0,0,0,0,0
Beerschot Wilrijk,Brian Plat,nl NED,DF,24.0,23.3,63,35,41,16,6,29,42,69.0,13,33,9,24,27,90,103,1
Beerschot Wilrijk,Tolis Konstantopoulos,gr GRE,DF,21.0,24.0,68,46,50,16,2,36,62,58.1,26,42,23,19,33,101,128,0
Beerschot Wilrijk,Loïc Mbe Soh,fr FRA,DF,23.0,22.0,25,15,21,4,0,10,16,62.5,6,29,17,12,12,37,131,2
Beerschot Wilrijk,Nick Shinton,be BEL,GK,23.0,20.5,2,0,2,0,0,2,5,40.0,3,0,0,0,0,2,15,0
Beerschot Wilrijk,Thibaud Verlinden,be BEL,MF,25.0,19.5,23,15,8,7,8,10,35,28.6,25,16,2,14,6,29,11,0
Beerschot Wilrijk,Faisal Al Ghamdi,sa KSA,MF,22.0,19.5,60,36,26,30,4,26,46,56.5,20,25,10,15,28,88,40,2
Beerschot Wilrijk,Ewan Henderson,sct SCO,MF,24.0,18.9,27,17,11,13,3,12,28,42.9,16,21,3,18,12,39,44,0
Beerschot Wilrijk,Colin Dagba,fr FRA,DF,25.0,15.3,59,40,32,22,5,30,47,63.8,17,21,6,15,10,69,25,0
Beerschot Wilrijk,Marwan Al Sahafi,sa KSA,FW,20.0,14.9,4,3,1,0,3,2,5,40.0,3,1,0,1,7,11,12,0
Beerschot Wilrijk,Antoine Colassin,be BEL,FW,23.0,13.5,23,14,4,13,6,10,20,50.0,10,18,2,16,8,31,12,1
Beerschot Wilrijk,Ryan Sanusi,be BEL,MF,32.0,11.4,21,12,15,5,1,10,21,47.6,11,23,8,15,11,32,19,0
Beerschot Wilrijk,Derrick Tshimanga,be BEL,DF,35.0,11.5,25,15,20,4,1,11,17,64.7,6,13,7,6,14,39,32,1
Beerschot Wilrijk,Tom Reyners,be BEL,MF,24.0,10.7,19,14,10,6,3,8,21,38.1,13,12,2,10,5,24,4,0
Beerschot Wilrijk,Hervé Matthys,be BEL,DF,28.0,10.1,9,5,5,4,0,6,16,37.5,10,15,11,4,19,28,32,0
Beerschot Wilrijk,Welat Cagro,be BEL,MF,25.0,10.5,17,10,7,8,2,6,16,37.5,10,14,1,13,7,24,5,0
Beerschot Wilrijk,Charly Keita,fr FRA,FW,25.0,11.2,7,4,1,5,1,3,6,50.0,3,17,4,13,2,9,19,0
Beerschot Wilrijk,Davor Matijas,hr CRO,GK,24.0,9.5,2,2,2,0,0,2,2,100.0,0,0,0,0,0,2,9,1
Beerschot Wilrijk,Omar Fayed,eg EGY,DF,21.0,8.2,25,17,16,8,1,8,11,72.7,3,8,6,2,21,46,46,1
Beerschot Wilrijk,Hakim Sahabo,rw RWA,MF,19.0,7.9,14,8,3,9,2,7,12,58.3,5,6,3,3,8,22,9,0
Beerschot Wilrijk,Ar'jany Martha,nl NED,MF,20.0,6.5,27,12,19,7,1,10,24,41.7,14,12,3,9,10,37,28,1
Beerschot Wilrijk,Simion Michez,be BEL,DF,22.0,5.4,15,7,4,10,1,10,12,83.3,2,12,0,12,7,22,14,0
Beerschot Wilrijk,Marco Weymans,bi BDI,DF,27.0,9.6,26,14,11,14,1,14,24,58.3,10,8,3,5,13,39,20,0
Beerschot Wilrijk,Ayouba Kosiah,lr LBR,"FW,DF",23.0,6.0,8,6,2,4,2,3,5,60.0,2,3,0,3,0,8,3,1
Beerschot Wilrijk,Rajiv van La Parra,nl NED,MF,33.0,5.2,8,4,2,4,2,1,5,20.0,4,5,0,5,5,13,5,0
Beerschot Wilrijk,Daishawn Redan,nl NED,FW,23.0,4.9,2,0,0,1,1,1,2,50.0,1,1,0,1,0,2,2,0
Beerschot Wilrijk,Dean Huiberts,nl NED,MF,24.0,3.9,15,7,7,6,2,9,14,64.3,5,4,2,2,5,20,5,0
Beerschot Wilrijk,Djevencio van der Kust,sr SUR,DF,23.0,2.2,4,3,4,0,0,2,4,50.0,2,4,1,3,2,6,8,0
Beerschot Wilrijk,Florian Krüger,de GER,FW,25.0,1.4,1,0,0,0,1,1,3,33.3,2,2,0,2,0,1,1,0
Beerschot Wilrijk,D'Margio Wright-Phillips,eng ENG,FW,22.0,1.8,2,0,0,0,2,1,5,20.0,4,0,0,0,1,3,0,0
Beerschot Wilrijk,Óscar Vargas,be BEL,DF,18.0,0.1,0,0,0,0,0,0,0,,0,0,0,0,0,0,0,0
Paris Saint Germain,Bradley Barcola,fr FRA,FW,21.0,24.2,27,17,10,8,9,8,31,25.8,23,25,2,23,19,46,12,0
Paris Saint Germain,Warren Zaïre-Emery,fr FRA,MF,18.0,22.8,51,26,17,21,13,23,45,51.1,22,35,6,29,23,74,20,2
Paris Saint Germain,Lucas Beraldo,br BRA,DF,20.0,22.3,38,31,30,8,0,23,37,62.2,14,16,8,8,21,59,63,3
Paris Saint Germain,João Neves,pt POR,MF,19.0,20.5,63,31,20,26,17,27,45,60.0,18,29,9,20,23,86,22,1
Paris Saint Germain,Fabián Ruiz Peña,es ESP,MF,28.0,21.4,37,24,13,15,9,21,47,44.7,26,25,3,22,16,53,27,1
Paris Saint Germain,Ousmane Dembélé,fr FRA,FW,27.0,19.2,11,5,0,7,4,4,12,33.3,8,3,0,3,9,20,2,1
Paris Saint Germain,Nuno Mendes,pt POR,DF,22.0,18.6,30,19,15,12,3,23,39,59.0,16,25,8,17,18,48,37,2
Paris Saint Germain,Lee Kang-in,kr KOR,FW,23.0,18.5,25,17,7,11,7,19,35,54.3,16,11,1,10,3,28,3,1
Paris Saint Germain,Désiré Doué,fr FRA,FW,19.0,19.2,48,30,15,19,14,24,51,47.1,27,26,0,26,13,61,7,0
Paris Saint Germain,Gonçalo Ramos,pt POR,FW,23.0,11.8,11,6,5,5,1,3,6,50.0,3,5,1,4,0,11,5,0
Paris Saint Germain,Khvicha Kvaratskhelia,ge GEO,FW,23.0,10.2,19,13,4,12,3,13,23,56.5,10,7,0,7,2,21,4,0
Paris Saint Germain,Lucas Hernández,fr FRA,DF,28.0,9.7,24,18,13,9,2,14,23,60.9,9,12,5,7,7,31,37,2
Marseille,Mason Greenwood,eng ENG,FW,22.0,31.2,35,18,10,14,11,16,39,41.0,23,7,0,7,12,47,5,2
Marseille,Luis Henrique,br BRA,DF,22.0,29.0,16,9,7,6,3,9,10,90.0,1,15,2,13,10,26,30,0
Marseille,Geoffrey Kondogbia,cf CTA,DF,31.0,22.4,60,38,31,26,3,27,34,79.4,7,23,6,17,22,82,64,4
Marseille,Quentin Merlin,fr FRA,DF,22.0,17.7,22,17,12,5,5,9,16,56.3,7,20,4,16,14,36,17,1
Marseille,Valentin Rongier,fr FRA,MF,29.0,17.4,50,28,14,31,5,27,43,62.8,16,30,9,21,33,83,28,5
Marseille,Neal Maupay,fr FRA,FW,27.0,11.6,9,4,1,6,2,3,6,50.0,3,5,0,5,2,11,0,0
Marseille,Amine Gouiri,dz ALG,FW,24.0,11.6,5,5,0,1,4,2,3,66.7,1,9,0,9,1,6,1,0
Marseille,Ulisses Garcia,ch SUI,DF,28.0,10.3,14,11,7,5,2,4,14,28.6,10,5,1,4,8,22,18,0
Marseille,Ismaël Bennacer,dz ALG,MF,26.0,7.2,21,10,8,12,1,12,18,66.7,6,6,0,6,10,31,2,1
Monaco,Maghnes Akliouche,fr FRA,FW,22.0,26.7,51,31,12,24,15,19,41,46.3,22,21,0,21,15,66,13,0
Monaco,Takumi Minamino,jp JPN,MF,29.0,24.8,33,19,7,14,12,15,42,35.7,27,26,1,25,10,43,20,0
Monaco,Lamine Camara,sn SEN,MF,20.0,22.8,66,41,22,34,10,26,48,54.2,22,30,4,26,31,97,32,1
Monaco,Denis Zakaria,ch SUI,MF,27.0,23.8,41,26,15,19,7,24,33,72.7,9,31,8,23,34,75,39,1
Monaco,Vanderson,br BRA,DF,23.0,22.9,76,48,37,30,9,45,64,70.3,19,43,6,37,39,115,65,2
Monaco,Caio Henrique Oliveira Silva,br BRA,DF,27.0,21.4,37,26,16,19,2,23,44,52.3,21,26,8,18,22,59,59,0
Monaco,Breel Embolo,ch SUI,FW,27.0,20.5,22,17,7,7,8,5,16,31.3,11,11,0,11,3,25,10,1
Monaco,Eliesse Ben Seghir,ma MAR,MF,19.0,19.4,31,22,12,12,7,18,32,56.3,14,20,0,20,13,44,4,0
Monaco,Mika Biereth,dk DEN,FW,21.0,13.6,5,5,0,3,2,3,7,42.9,4,11,0,11,4,9,7,0
Monaco,Aleksandr Golovin,ru RUS,MF,28.0,12.8,38,24,9,20,9,17,39,43.6,22,16,4,12,12,50,7,0
Monaco,Jordan Teze,nl NED,DF,24.0,6.3,18,9,8,9,1,7,16,43.8,9,12,1,11,6,24,15,0
Monaco,Folarin Balogun,us USA,FW,23.0,6.8,1,1,0,0,1,0,4,0.0,4,0,0,0,1,2,0,0
Monaco,Kassoum Ouattara,fr FRA,DF,19.0,4.3,9,7,5,4,0,4,14,28.6,10,6,0,6,5,14,2,1
Monaco,Krépin Diatta,sn SEN,DF,25.0,5.6,18,12,13,2,3,14,24,58.3,10,5,1,4,9,27,12,2
Paris Saint Germain,Warren Zaïre-Emery,fr FRA,MF,18.0,22.8,51,26,17,21,13,23,45,51.1,22,35,6,29,23,74,20,2
Paris Saint Germain,João Neves,pt POR,MF,19.0,20.5,63,31,20,26,17,27,45,60.0,18,29,9,20,23,86,22,1
Paris Saint Germain,Lee Kang-in,kr KOR,FW,23.0,18.5,25,17,7,11,7,19,35,54.3,16,11,1,10,3,28,3,1
Paris Saint Germain,Désiré Doué,fr FRA,FW,19.0,19.2,48,30,15,19,14,24,51,47.1,27,26,0,26,13,61,7,0
Paris Saint Germain,Marco Asensio,es ESP,FW,28.0,6.9,4,3,1,3,0,0,6,0.0,6,1,0,1,0,4,1,0
Paris Saint Germain,Ibrahim Mbaye,fr FRA,FW,16.0,3.8,4,2,1,2,1,3,8,37.5,5,2,0,2,2,6,2,0
Paris Saint Germain,Yoram Zague,fr FRA,DF,18.0,2.0,8,6,3,1,4,6,8,75.0,2,3,0,3,2,10,2,0
Paris Saint Germain,Axel Tapé,fr FRA,DF,16.0,2.0,3,1,1,2,0,2,2,100.0,0,2,2,0,1,4,5,0
